year,Population,Adults,Children,Singles,Taken,Hunger Deaths,Old Age Deaths,Average Age,Average Hunger,Average Prowess,Average Selfishness,Average Reciprocity
0,22,20,2,8,14,0,0,27.363636363636363,13.831823977899301,43.12272147664615,30.454545454545453,69.54545454545455
1,25,20,5,8,17,0,0,25.08,14.8,43.44,34.88,65.12
2,26,20,6,8,18,0,0,25.115384615384617,11.538461538461538,43.23076923076923,36.92307692307692,63.07692307692308
3,27,20,7,8,19,0,0,25.185185185185187,11.481481481481481,42.925925925925924,36.74074074074074,63.25925925925926
4,27,20,7,8,19,0,0,26.185185185185187,10.0,42.55555555555556,36.74074074074074,63.25925925925926
5,30,20,10,8,22,0,0,24.566666666666666,14.0,41.5,38.13333333333333,61.86666666666667
6,32,20,12,8,24,0,0,24.03125,12.5,42.59375,38.8125,61.1875
7,32,20,12,10,22,0,0,25.03125,10.0,41.96875,38.8125,61.1875
8,36,20,16,10,26,0,0,23.25,14.444444444444445,41.97222222222222,43.30555555555556,56.69444444444444
9,39,20,19,10,29,0,0,22.46153846153846,13.384706022093283,44.28196064457339,45.256410256410255,54.743589743589745
10,39,20,19,10,29,0,0,23.46153846153846,10.856060954411658,42.96445186610116,45.256410256410255,54.743589743589745
11,41,20,21,10,31,0,0,23.317073170731707,12.115891255285934,44.030450208128705,47.19512195121951,52.80487804878049
12,41,20,21,10,31,0,0,24.317073170731707,10.982927857861913,42.72438921530882,47.19512195121951,52.80487804878049
13,45,20,25,10,35,0,0,23.155555555555555,14.334372974477477,41.95451591441141,47.46666666666667,52.53333333333333
14,47,20,27,10,37,0,0,23.170212765957448,14.694595389330791,39.07136205747772,46.61702127659574,53.38297872340426
15,47,20,27,10,37,0,0,24.170212765957448,14.734792498439807,36.903505373900614,46.61702127659574,53.38297872340426
16,50,22,28,12,38,0,0,23.72,17.178067421005167,35.76193257899484,47.5,52.5
17,54,25,29,12,42,0,0,22.962962962962962,18.41936818404998,37.28433551965372,46.833333333333336,53.166666666666664
18,56,26,30,12,44,0,0,23.142857142857142,19.43039737073204,35.051745486410816,46.44642857142857,53.55357142857143
19,58,27,31,12,46,0,0,23.344827586206897,20.65086558267805,34.745686141459885,46.08620689655172,53.91379310344828
20,59,27,32,14,45,0,0,23.949152542372882,21.59662160433309,33.43727670075165,46.23728813559322,53.76271186440678
21,55,24,31,11,44,6,0,21.12727272727273,20.95423311328167,34.973039613991055,48.527272727272724,51.472727272727276
22,53,23,30,9,44,9,0,19.9811320754717,22.364650172273723,32.40893473338665,50.16981132075472,49.83018867924528
23,50,19,31,10,40,12,1,18.58,19.88714472905881,33.556624603304456,49.84,50.16
24,52,21,31,12,40,13,1,17.826923076923077,22.78611590612352,33.259646138120544,51.92307692307692,48.07692307692308
25,51,23,28,10,41,13,3,17.019607843137255,19.428485805684364,36.434242393631116,53.627450980392155,46.372549019607845
26,50,20,30,12,38,15,4,15.6,19.77505553121942,36.02494446878058,54.08,45.92
27,51,22,29,12,39,15,4,16.294117647058822,22.953254257848624,31.24282417352393,54.470588235294116,45.529411764705884
28,51,22,29,12,39,15,4,17.294117647058822,22.807242722294113,30.408443552215697,54.470588235294116,45.529411764705884
29,51,24,27,14,37,15,4,18.294117647058822,23.70444725599832,29.51123901851148,54.470588235294116,45.529411764705884
30,54,28,26,14,40,15,4,18.27777777777778,24.906478241210955,30.1490773143446,54.0,46.0
31,55,28,27,14,41,15,4,18.945454545454545,26.00449731906171,26.740957226392837,53.58181818181818,46.41818181818182
32,55,30,25,14,41,15,5,19.363636363636363,25.34987828941916,28.166426451994504,54.0,46.0
33,58,33,25,16,42,15,5,19.362068965517242,28.104159924241106,27.051012489551997,54.51724137931034,45.48275862068966
34,58,33,25,16,42,17,5,18.17241379310345,27.779864298682522,25.461515011662303,54.8448275862069,45.1551724137931
35,60,33,27,18,42,17,6,18.05,26.962633286542047,27.67576864701385,52.483333333333334,47.516666666666666
36,60,35,25,20,40,17,8,18.716666666666665,26.397173598083462,27.369493068583203,52.483333333333334,47.516666666666666
37,64,37,27,22,42,17,8,18.546875,27.573979568837245,27.785395431162755,51.296875,48.703125
38,67,38,29,22,45,18,8,17.70149253731343,28.575910553935326,25.864362071535158,50.3134328358209,49.6865671641791
39,70,37,33,21,49,18,10,16.942857142857143,28.827606779691997,26.656970641942067,49.371428571428574,50.628571428571426
40,68,37,31,20,48,18,12,17.36764705882353,28.601741422273495,23.64636857070027,49.51470588235294,50.48529411764706
41,71,37,34,20,51,18,12,17.633802816901408,30.760484066307583,24.225431426650157,49.71830985915493,50.28169014084507
42,73,38,35,22,51,18,13,17.71232876712329,31.490231069659544,23.523467560477442,48.76712328767123,51.23287671232877
43,74,38,36,22,52,18,14,17.95945945945946,32.70577875134917,22.375302335318903,49.5945945945946,50.4054054054054
44,76,38,38,22,54,18,15,18.07894736842105,34.60422300883149,20.685250675379038,48.73684210526316,51.26315789473684
45,74,36,38,20,54,18,20,18.216216216216218,32.026467308808584,24.478113684070845,50.189189189189186,49.810810810810814
46,75,36,39,18,57,18,23,17.906666666666666,31.669030120437075,26.584303212896266,49.96,50.04
47,73,34,39,16,57,18,26,17.945205479452056,30.550546380611674,25.000462468238233,48.54794520547945,51.45205479452055
48,72,33,39,18,54,18,28,18.27777777777778,30.266880524433063,26.302812617313396,47.18055555555556,52.81944444444444
49,75,35,40,18,57,18,29,18.08,31.871270257497237,27.328729742502766,47.21333333333333,52.78666666666667
50,78,35,43,18,60,18,30,17.94871794871795,32.39995783201304,26.80517037311516,48.19230769230769,51.80769230769231
51,77,36,41,17,60,18,33,18.09090909090909,30.317935338070363,28.123623103488075,47.97402597402598,52.02597402597402
52,75,35,40,14,61,18,37,18.04,27.622424780092807,30.790908553240527,47.81333333333333,52.18666666666667
53,75,40,35,14,61,18,37,19.04,28.958888951957917,28.387777714708754,47.81333333333333,52.18666666666667
54,76,40,36,20,56,18,38,19.36842105263158,30.143397782343413,28.382918007130275,48.01315789473684,51.98684210526316
55,76,40,36,18,58,18,41,19.07894736842105,29.42172688541501,29.933537414686743,48.21052631578947,51.78947368421053
56,76,40,36,17,59,18,43,19.092105263157894,27.970369190288345,30.648051862343234,48.46052631578947,51.53947368421053
57,76,39,37,17,59,18,45,19.67105263157895,28.554913732717804,29.58982310938746,46.38157894736842,53.61842105263158
58,80,42,38,17,63,18,45,19.6875,31.43711067710451,26.96288932289549,45.4875,54.5125
59,80,46,34,17,63,18,46,20.225,32.36520229284227,24.28479770715773,45.125,54.875
60,77,44,33,17,60,18,50,20.103896103896105,30.699406654567376,26.352541397380676,46.25974025974026,53.74025974025974
61,78,42,36,16,62,19,52,19.128205128205128,30.93533004999105,25.59338462652882,47.06410256410256,52.93589743589744
62,80,47,33,16,64,19,52,19.65,31.834176699141004,23.29082330085899,46.8,53.2
63,83,47,36,15,68,19,53,19.53012048192771,33.64735115486475,21.526427660614296,46.9277108433735,53.0722891566265
64,83,45,38,15,68,21,55,18.686746987951807,34.996266245322225,19.04498244967489,46.04819277108434,53.95180722891566
65,82,47,35,17,65,21,56,19.426829268292682,35.737473571409296,15.93325813590777,45.829268292682926,54.170731707317074
66,83,48,35,16,67,21,57,19.602409638554217,38.34553609215583,14.003861498205612,45.72289156626506,54.27710843373494
67,78,45,33,18,60,21,62,20.397435897435898,36.97706998963288,15.233852936473594,45.26923076923077,54.73076923076923
68,79,48,31,17,62,21,66,20.329113924050635,36.701972410425384,18.731137082573067,44.36708860759494,55.63291139240506
69,79,49,30,17,62,21,67,21.240506329113924,37.40745478435657,15.59254521564344,44.36708860759494,55.63291139240506
70,78,50,28,19,59,21,69,21.974358974358974,36.52056562139025,17.924832952811755,44.11538461538461,55.88461538461539
71,77,52,25,21,56,21,72,22.87012987012987,35.68374001457295,19.290285959453023,42.77922077922078,57.22077922077922
72,77,52,25,20,57,22,74,22.98701298701299,35.35165869594883,20.570419226129093,43.18181818181818,56.81818181818182
73,70,48,22,18,52,23,81,22.82857142857143,31.020265237348195,22.643313988360024,43.51428571428571,56.48571428571429
74,70,49,21,18,52,23,82,23.728571428571428,30.66615162363646,22.876705519220682,43.84285714285714,56.15714285714286
75,71,49,22,17,54,24,83,23.52112676056338,29.735717524388498,23.447381067160798,44.436619718309856,55.563380281690144
76,72,49,23,16,56,25,83,23.47222222222222,31.607353727543163,20.225979605790176,43.94444444444444,56.05555555555556
77,73,49,24,16,57,25,84,23.972602739726028,32.665897337659345,17.701153692746825,44.082191780821915,55.917808219178085
78,72,49,23,15,57,25,87,24.11111111111111,31.191856898902504,19.846951869260653,44.888888888888886,55.111111111111114
79,73,48,25,15,58,25,88,24.273972602739725,31.686887603164095,19.491194588616725,45.28767123287671,54.71232876712329
80,71,48,23,14,57,25,90,25.183098591549296,29.87369330809611,19.491334768454205,45.394366197183096,54.605633802816904
81,66,45,21,11,55,25,95,25.62121212121212,24.848704649406525,23.47532976126553,46.34848484848485,53.65151515151515
82,64,43,21,10,54,27,95,25.71875,24.491661796346197,24.86714006047042,46.203125,53.796875
83,65,43,22,12,53,27,95,26.323076923076922,24.989723959546478,25.102583732761218,46.03076923076923,53.96923076923077
84,66,45,21,12,54,27,95,26.924242424242426,24.38069152488572,25.801126656932468,46.40909090909091,53.59090909090909
85,64,44,20,11,53,29,95,27.109375,23.955782416257584,25.231717583742416,46.375,53.625
86,63,42,21,11,52,30,96,26.936507936507937,22.35106786405115,27.252106739123455,46.507936507936506,53.492063492063494
87,64,43,21,13,51,30,96,27.515625,22.150176077981833,27.568573922018167,45.921875,54.078125
88,64,44,20,13,51,32,96,26.921875,23.54911429663734,26.84151070336266,47.109375,52.890625
89,66,45,21,13,53,32,96,27.106060606060606,25.267862861160776,25.353349260051345,46.015151515151516,53.984848484848484
90,68,46,22,15,53,32,96,27.308823529411764,26.257955048817866,24.78616259824096,46.11764705882353,53.88235294117647
91,69,49,20,14,55,32,97,27.217391304347824,26.048995460696258,24.38578714799939,45.26086956521739,54.73913043478261
92,69,49,20,13,56,33,97,27.434782608695652,27.23844614470753,21.491128483883866,44.55072463768116,55.44927536231884
93,69,50,19,13,56,33,98,28.159420289855074,28.129312122379424,21.359184291881416,44.0,56.0
94,69,51,18,13,56,34,98,28.420289855072465,29.524264044095638,20.5626924776435,43.82608695652174,56.17391304347826
95,69,52,17,13,56,34,99,28.652173913043477,30.040745805448672,20.133167238029586,43.89855072463768,56.10144927536232
96,68,52,16,13,55,35,99,29.323529411764707,30.383060526926656,18.690468884838054,44.23529411764706,55.76470588235294
97,67,51,16,12,55,35,100,30.044776119402986,29.20921850199694,19.849825184280924,44.53731343283582,55.46268656716418
98,65,48,17,11,54,37,101,29.892307692307693,28.033705663198372,23.389061540378233,44.353846153846156,55.646153846153844
99,63,46,17,11,52,40,101,29.095238095238095,26.606649221370294,21.924679149218154,45.904761904761905,54.095238095238095
100,64,47,17,11,53,40,101,29.640625,26.263489035557633,23.439635964442367,45.609375,54.390625
101,63,44,19,12,51,42,102,28.666666666666668,24.98450707967095,24.698032602868732,46.34920634920635,53.65079365079365
102,62,44,18,12,50,43,102,29.161290322580644,24.993042693397317,23.4101831130543,46.20967741935484,53.79032258064516
103,60,44,16,12,48,44,103,30.033333333333335,22.383064359440617,25.7842842447561,44.85,55.15
104,60,45,15,14,46,44,103,31.033333333333335,22.66293142241232,25.67040191092101,44.85,55.15
105,60,47,13,13,47,45,103,31.116666666666667,23.057252135850565,25.44274786414944,44.36666666666667,55.63333333333333
106,58,44,14,13,45,48,103,30.482758620689655,23.22892754363837,25.821522331259256,44.58620689655172,55.41379310344828
107,58,44,14,13,45,50,103,29.655172413793103,22.44778447453532,26.46228310853557,45.58620689655172,54.41379310344828
108,56,43,13,12,44,52,103,29.535714285714285,21.08760462750406,25.733497989076692,46.589285714285715,53.410714285714285
109,56,43,13,12,44,53,103,29.625,23.151207314889714,24.14871316005173,46.214285714285715,53.785714285714285
110,55,44,11,12,43,54,103,30.21818181818182,24.058896539302648,23.322921642515535,46.43636363636364,53.56363636363636
111,56,45,11,14,42,54,103,30.678571428571427,23.71492306789606,24.945791217818226,47.107142857142854,52.892857142857146
112,54,42,12,13,41,57,103,29.90740740740741,24.387616974227104,24.80758195064871,48.851851851851855,51.148148148148145
113,53,40,13,12,41,58,104,29.566037735849058,23.873661225933787,25.635772736330363,49.81132075471698,50.18867924528302
114,53,40,13,11,42,59,104,29.339622641509433,23.522044059633444,25.61003141206467,49.22641509433962,50.77358490566038
115,51,39,12,12,39,60,105,29.901960784313726,20.791055604098926,27.46384635668539,48.80392156862745,51.19607843137255
116,50,38,12,13,37,62,105,29.12,22.00401869721195,26.795981302788046,48.08,51.92
117,51,40,11,13,38,62,105,29.54901960784314,22.20262047380727,26.640516781094686,48.05882352941177,51.94117647058823
118,50,39,11,12,38,63,105,30.12,21.429411349087644,25.57058865091236,48.1,51.9
119,50,39,11,12,38,63,105,31.12,21.017533650027808,25.982466349972192,48.1,51.9
120,52,39,13,12,40,63,105,30.923076923076923,20.60732825928799,28.334979433019704,47.44230769230769,52.55769230769231
121,50,37,13,10,40,66,105,29.52,19.5696846305168,28.143653160234862,47.04,52.96
122,53,37,16,12,41,66,105,28.849056603773583,19.887679231898062,32.33873586244157,46.16981132075472,53.83018867924528
123,54,38,16,12,42,67,105,28.37037037037037,20.949004442206313,31.032477039275168,47.166666666666664,52.833333333333336
124,55,39,16,12,43,67,105,28.854545454545455,22.542871545178297,28.40258300027625,46.836363636363636,53.163636363636364
125,55,39,16,11,44,68,105,28.89090909090909,22.068046548139087,27.787414113528232,46.8,53.2
126,55,38,17,11,44,69,105,28.945454545454545,22.245857457203687,27.912478974130114,47.58181818181818,52.41818181818182
127,54,36,18,11,43,71,105,28.555555555555557,23.398157890568694,28.03029233480763,46.53703703703704,53.46296296296296
128,54,35,19,13,41,73,105,27.574074074074073,24.47252928384084,29.194137382825833,44.75925925925926,55.24074074074074
129,53,34,19,11,42,74,106,27.30188679245283,24.611593348228993,27.53935004799742,45.471698113207545,54.528301886792455
130,49,31,18,10,39,79,106,24.93877551020408,21.271874081538726,32.8301667347878,44.51020408163265,55.48979591836735
131,48,29,19,9,39,80,107,24.479166666666668,20.518710118248332,33.571023338222325,45.604166666666664,54.395833333333336
132,48,29,19,8,40,81,107,24.375,21.025099862218365,33.87709887960643,44.791666666666664,55.208333333333336
133,47,29,18,8,39,81,108,25.02127659574468,18.675557158398977,35.38827262883506,45.48936170212766,54.51063829787234
134,47,29,18,8,39,81,108,26.02127659574468,17.362653407534285,36.913942337146565,45.48936170212766,54.51063829787234
135,46,28,18,7,39,82,108,26.47826086956522,17.30552117208887,37.00694741007128,45.71739130434783,54.28260869565217
136,47,29,18,7,40,82,108,26.914893617021278,16.801711910661368,38.04935191912587,45.191489361702125,54.808510638297875
137,46,29,17,9,37,83,108,27.391304347826086,15.752349171706378,38.16660208211439,44.21739130434783,55.78260869565217
138,47,31,16,11,36,83,108,27.80851063829787,16.06887729781607,38.76090993622648,44.48936170212766,55.51063829787234
139,46,32,14,10,36,85,108,26.91304347826087,14.740342934738933,41.02052663047846,45.369565217391305,54.630434782608695
140,45,33,12,10,35,86,108,27.177777777777777,15.572653180648153,38.87179126379629,45.53333333333333,54.46666666666667
141,44,31,13,8,36,89,108,25.136363636363637,15.702704787180846,37.238537040050566,43.79545454545455,56.20454545454545
142,44,31,13,8,36,89,108,26.136363636363637,15.434724638167616,36.67891172546875,43.79545454545455,56.20454545454545
143,44,33,11,8,36,89,108,27.136363636363637,15.840557374088133,36.273078989548225,43.79545454545455,56.20454545454545
144,43,34,9,10,33,90,108,27.53488372093023,15.484603764368536,36.49214042167798,43.53488372093023,56.46511627906977
145,44,35,9,10,34,90,108,27.90909090909091,15.427343358216744,38.16356573269234,43.65909090909091,56.34090909090909
146,45,36,9,10,35,90,108,28.288888888888888,15.317303582149943,39.06047419562783,42.91111111111111,57.08888888888889
147,46,37,9,10,36,90,108,28.67391304347826,14.91643096010595,38.73574295293753,43.58695652173913,56.41304347826087
148,45,37,8,12,33,91,108,29.177777777777777,14.871405732930391,36.43970537818072,42.77777777777778,57.22222222222222
149,45,36,9,11,34,92,108,28.955555555555556,15.563373247603069,36.21442036182313,41.4,58.6
150,45,35,10,11,34,93,108,28.68888888888889,14.79395895860817,37.421353641230546,42.24444444444445,57.75555555555555
151,44,34,10,12,32,94,108,29.15909090909091,14.309883086409819,35.940116913590174,42.59090909090909,57.40909090909091
152,46,34,12,14,32,94,108,28.891304347826086,15.076825614687552,37.96665264618201,42.84782608695652,57.15217391304348
153,46,34,12,13,33,95,108,28.565217391304348,15.311092614442444,35.482685880899105,44.28260869565217,55.71739130434783
154,47,34,13,13,34,95,108,28.95744680851064,16.369353413960884,35.46043382008166,44.12765957446808,55.87234042553192
155,48,34,14,13,35,96,108,28.083333333333332,18.686876036561205,34.41729063010546,43.6875,56.3125
156,49,35,14,15,34,96,108,28.510204081632654,19.672673573632956,33.14365295697929,44.12244897959184,55.87755102040816
157,51,37,14,17,34,96,108,28.392156862745097,20.39510563216858,33.997051230576524,44.80392156862745,55.19607843137255
158,48,34,14,17,31,98,109,27.958333333333332,17.798651731777742,36.00052327281107,45.333333333333336,54.666666666666664
159,49,33,16,16,33,99,109,27.306122448979593,19.277750838658985,37.028371610320605,45.93877551020408,54.06122448979592
160,50,33,17,16,34,99,109,27.76,18.816645220247555,36.303354779752446,46.44,53.56
161,53,34,19,20,33,99,109,27.18867924528302,19.648755331840537,37.6908673096689,48.37735849056604,51.62264150943396
162,53,34,19,19,34,100,109,26.81132075471698,20.23454400864861,34.44470127437027,47.9622641509434,52.0377358490566
163,54,35,19,19,35,100,109,27.314814814814813,20.66504161782024,34.59421764143902,47.907407407407405,52.092592592592595
164,57,33,24,18,39,102,109,25.087719298245613,21.208866355404584,37.304956544179674,48.40350877192982,51.59649122807018
165,57,33,24,20,37,103,109,24.982456140350877,19.750766468416032,35.44221598772432,47.96491228070175,52.03508771929825
166,58,33,25,20,38,104,109,24.53448275862069,21.807234144408927,33.333593579722056,47.56896551724138,52.43103448275862
167,63,33,30,20,43,104,109,23.58730158730159,23.985351145061028,34.28449012478024,47.34920634920635,52.65079365079365
168,62,31,31,20,42,107,109,22.193548387096776,24.82345058022481,32.644291355259064,47.016129032258064,52.983870967741936
169,62,31,31,19,43,108,109,22.338709677419356,25.647959615920925,31.14236296472424,46.91935483870968,53.08064516129032
170,64,32,32,23,41,108,109,22.640625,27.27032999714966,30.651545002850348,47.328125,52.671875
171,66,33,33,23,43,108,111,21.439393939393938,26.3380788819763,33.11646657256915,47.34848484848485,52.65151515151515
172,69,32,37,24,45,109,112,20.057971014492754,26.88385276080211,34.32096984177953,46.666666666666664,53.333333333333336
173,68,32,36,23,45,109,113,20.61764705882353,27.128097910541623,30.63660797181132,46.13235294117647,53.86764705882353
174,70,31,39,24,46,109,115,19.6,27.307285869979374,33.296148415734905,48.58571428571429,51.41428571428571
175,69,30,39,21,48,111,116,18.44927536231884,26.930400141557115,31.373947684529846,48.333333333333336,51.666666666666664
176,72,30,42,21,51,111,116,18.680555555555557,29.359722771849444,28.654166117039445,48.52777777777778,51.47222222222222
177,72,30,42,20,52,112,117,18.36111111111111,30.21650817354704,27.642497475013613,49.25,50.75
178,71,30,41,19,52,113,118,18.183098591549296,29.828306738189458,27.12943974068378,49.647887323943664,50.352112676056336
179,72,31,41,18,54,114,118,18.22222222222222,30.97673711808304,27.259373993028074,50.083333333333336,49.916666666666664
180,73,34,39,18,55,114,118,18.972602739726028,34.280455717295645,22.96611962517011,49.9041095890411,50.0958904109589
181,74,34,40,17,57,115,120,18.18918918918919,35.387115402958166,23.765740049547066,50.0945945945946,49.9054054054054
182,75,36,39,22,53,115,122,18.32,36.27245317033345,23.27421349633322,50.56,49.44
183,73,37,36,22,51,117,124,17.52054794520548,34.35135350773301,23.936317725143695,49.54794520547945,50.45205479452055
184,75,37,38,22,53,117,126,17.133333333333333,33.94322453414005,24.536775465859947,50.13333333333333,49.86666666666667
185,72,33,39,18,54,118,130,16.22222222222222,31.014768290744957,27.078135417487577,50.375,49.625
186,73,33,40,19,54,118,131,16.575342465753426,32.057503342693416,25.805510355936722,49.93150684931507,50.06849315068493
187,73,35,38,18,55,118,133,16.589041095890412,32.243803446771366,24.929820742070362,50.082191780821915,49.917808219178085
188,76,38,38,20,56,118,133,16.93421052631579,34.709435759412585,24.553722135324254,49.71052631578947,50.28947368421053
189,77,40,37,19,58,118,135,17.233766233766232,34.82671752677839,25.121334421273552,49.064935064935064,50.935064935064936
190,74,39,35,17,57,118,139,17.64864864864865,33.54768980041208,24.87288657657381,49.66216216216216,50.33783783783784
191,72,39,33,17,55,118,142,18.27777777777778,31.287729612789924,25.795839550655433,49.27777777777778,50.72222222222222
192,73,41,32,17,56,118,143,18.602739726027398,32.21374371669813,26.39827984270733,49.35616438356164,50.64383561643836
193,75,42,33,17,58,118,145,18.6,32.88415245498213,26.707055131038125,47.70666666666666,52.29333333333334
194,76,42,34,17,59,118,146,19.263157894736842,34.13486254995609,23.299347976359698,47.723684210526315,52.276315789473685
195,76,41,35,18,58,118,148,19.44736842105263,35.46731970012927,21.440575036712836,47.526315789473685,52.473684210526315
196,75,42,33,16,59,120,148,19.213333333333335,38.9261235912701,17.380543075396563,48.08,51.92
197,73,39,34,16,57,121,152,18.383561643835616,38.24429261777891,17.503688844299937,49.0958904109589,50.9041095890411
198,76,43,33,16,60,121,152,18.657894736842106,40.72853325114448,15.35041411727657,50.73684210526316,49.26315789473684
199,70,38,32,14,56,121,159,18.642857142857142,37.09437346807577,17.319912246209952,52.25714285714286,47.74285714285714
200,66,34,32,16,50,121,165,18.333333333333332,32.13792853983691,22.824428809333796,53.07575757575758,46.92424242424242
201,65,34,31,16,49,121,166,19.06153846153846,32.22115224955701,21.747945740619638,52.6,47.4
202,66,37,29,16,50,121,166,19.772727272727273,32.95243820385996,21.971804220382467,52.54545454545455,47.45454545454545
203,65,37,28,17,48,122,167,19.784615384615385,32.158059738310605,22.8419402616894,52.276923076923076,47.723076923076924
204,65,37,28,17,48,122,169,19.815384615384616,30.871010566047282,25.913913027012946,52.215384615384615,47.784615384615385
205,66,40,26,17,49,122,169,20.515151515151516,30.911455259649316,24.588544740350684,51.86363636363637,48.13636363636363
206,68,42,26,17,51,122,169,20.91176470588235,32.15669347651711,24.299188876424054,52.39705882352941,47.60294117647059
207,68,41,27,15,53,124,169,20.352941176470587,33.405093333540385,20.944908095002706,51.61764705882353,48.38235294117647
208,68,40,28,16,52,124,171,20.33823529411765,32.08825080242871,21.720572726983065,52.39705882352941,47.60294117647059
209,67,41,26,17,50,124,173,20.611940298507463,30.88523435335713,21.88680348461359,51.64179104477612,48.35820895522388
210,69,41,28,17,52,124,174,20.492753623188406,31.5401373182369,22.185170211561744,52.028985507246375,47.971014492753625
211,69,42,27,16,53,124,175,20.942028985507246,33.23073451370762,18.406946645712672,52.81159420289855,47.18840579710145
212,67,42,25,14,53,124,177,21.62686567164179,32.82287767589865,18.654734264399853,53.25373134328358,46.74626865671642
213,66,44,22,13,53,125,178,21.893939393939394,33.99726013162068,17.230012595652052,53.121212121212125,46.878787878787875
214,65,45,20,13,52,125,179,22.73846153846154,33.01784812955824,17.689844178134063,53.646153846153844,46.353846153846156
215,67,46,21,13,54,125,179,23.059701492537314,33.7235310357423,17.93318538216815,54.11940298507463,45.88059701492537
216,66,47,19,13,53,125,180,24.21212121212121,34.49650810795531,15.655007043559841,54.484848484848484,45.515151515151516
217,67,48,19,13,54,125,181,24.65671641791045,34.695814158085334,17.871350021019143,55.04477611940298,44.95522388059702
218,63,45,18,12,51,126,185,24.96825396825397,32.859522271779745,17.44386961216775,56.17460317460318,43.82539682539682
219,60,43,17,12,48,126,188,25.7,30.456243994160886,20.16042267250578,55.35,44.65
220,60,44,16,12,48,126,188,26.7,31.616939246133843,18.999727420532817,55.35,44.65
221,60,43,17,12,48,126,189,27.133333333333333,32.062086023141084,19.471247310192254,54.45,45.55
222,61,43,18,11,50,127,189,26.83606557377049,34.095802202107734,17.652793061582233,55.278688524590166,44.721311475409834
223,59,42,17,11,48,127,192,27.35593220338983,30.6742975099676,20.98671943918494,57.559322033898304,42.440677966101696
224,57,40,17,10,47,128,194,27.017543859649123,30.075864443439,22.648685675113057,57.1578947368421,42.8421052631579
225,58,42,16,10,48,128,194,27.551724137931036,30.33734963504439,22.45575381323147,57.55172413793103,42.44827586206897
226,60,44,16,11,49,129,194,26.583333333333332,32.93574283480598,21.74759049852736,56.38333333333333,43.61666666666667
227,59,44,15,11,48,129,195,27.440677966101696,31.49437108630858,21.268340778098203,56.54237288135593,43.45762711864407
228,59,44,15,13,46,129,195,28.440677966101696,32.25987490029787,20.50283696410891,56.54237288135593,43.45762711864407
229,56,42,14,12,44,129,198,28.642857142857142,28.949511750310347,24.693345392546796,57.982142857142854,42.017857142857146
230,56,41,15,12,44,130,198,28.732142857142858,28.477449042926644,26.575866309175392,57.25,42.75
231,55,41,14,13,42,130,199,29.363636363636363,26.249813900435655,29.350186099564347,57.03636363636364,42.96363636363636
232,53,38,15,12,41,132,200,28.49056603773585,24.228144926450337,29.62097102869949,57.132075471698116,42.867924528301884
233,51,39,12,11,40,133,201,28.50980392156863,24.2162238236577,28.254364411636416,57.05882352941177,42.94117647058823
234,50,37,13,11,39,133,203,29.2,22.01993904878766,31.85699333743561,56.36,43.64
235,50,38,12,11,39,133,203,30.2,20.677191505665,32.602808494334994,56.36,43.64
236,52,38,14,11,41,133,203,30.03846153846154,22.84303897067878,31.310807183167377,57.26923076923077,42.73076923076923
237,51,37,14,10,41,135,203,29.215686274509803,23.577639212786462,28.816608789572733,56.509803921568626,43.490196078431374
238,52,38,14,10,42,135,203,29.653846153846153,23.395886429824028,28.20026741632982,55.5,44.5
239,50,38,12,10,40,136,204,30.26,21.776145808035643,27.89299480816497,54.02,45.98
240,50,38,12,12,38,136,204,31.26,20.000404938558148,30.139595061441852,54.02,45.98
241,50,39,11,12,38,137,204,31.16,19.383833443597243,31.516166556402755,53.08,46.92
242,50,41,9,11,39,138,204,31.1,19.298787929028084,31.02121207097192,54.52,45.48
243,51,41,10,11,40,138,204,31.49019607843137,19.727525037736953,31.09600437402775,54.588235294117645,45.411764705882355
244,52,41,11,11,41,138,204,31.884615384615383,20.380523628056018,30.75409175655937,54.07692307692308,45.92307692307692
245,55,41,14,11,44,138,204,31.145454545454545,21.201085050497568,30.544369494956975,56.2,43.8
246,55,38,17,10,45,141,204,29.236363636363638,22.413502254276004,30.559932459664434,54.38181818181818,45.61818181818182
247,57,39,18,10,47,141,204,29.210526315789473,22.686413109695575,28.927621978023723,54.228070175438596,45.771929824561404
248,54,36,18,9,45,144,205,28.35185185185185,21.28896871911507,29.99143874561079,54.833333333333336,45.166666666666664
249,51,33,18,8,43,147,205,27.784313725490197,21.184711251038706,28.46464470967993,54.09803921568628,45.90196078431372
250,49,31,18,7,42,150,205,26.408163265306122,20.804526767997917,28.45252738934946,52.40816326530612,47.59183673469388
251,49,31,18,7,42,150,205,27.408163265306122,18.609788104099188,31.655518018349785,52.40816326530612,47.59183673469388
252,48,31,17,6,42,151,206,26.708333333333332,17.073107616382426,34.62653439305027,50.125,49.875
253,48,32,16,6,42,151,206,27.708333333333332,17.299417389697886,33.38808261030211,50.125,49.875
254,47,31,16,5,42,152,206,28.085106382978722,17.48639365479829,33.981691451584695,51.04255319148936,48.95744680851064
255,46,31,15,5,41,153,206,28.565217391304348,17.270269719528955,33.490599845688436,50.630434782608695,49.369565217391305
256,46,31,15,7,39,153,206,29.565217391304348,15.636217630538196,35.12465193467919,50.630434782608695,49.369565217391305
257,46,32,14,7,39,153,206,30.565217391304348,14.873219076886448,35.88765048833095,50.630434782608695,49.369565217391305
258,46,31,15,8,38,154,206,30.23913043478261,15.433017345622577,35.30611308916003,51.67391304347826,48.32608695652174
259,45,31,14,8,37,156,206,29.622222222222224,16.230830295447472,35.74781224587979,50.28888888888889,49.71111111111111
260,44,29,15,7,37,158,206,28.704545454545453,16.2267077715221,36.40965586484153,50.31818181818182,49.68181818181818
261,44,31,13,9,35,159,206,28.5,14.319381050598599,38.31698258576504,50.56818181818182,49.43181818181818
262,45,34,11,9,36,159,206,28.866666666666667,14.596810306509436,37.758745249046115,50.666666666666664,49.333333333333336
263,43,32,11,7,36,162,206,26.906976744186046,14.36604764754903,37.42465002686958,50.0,50.0
264,43,33,10,7,36,162,206,27.906976744186046,12.748288731666982,38.57729266368186,50.0,50.0
265,44,35,9,7,37,162,206,28.272727272727273,12.893534238968256,39.69737485194083,49.68181818181818,50.31818181818182
266,44,36,8,7,37,162,206,29.272727272727273,11.825325327904524,39.629220126640924,49.68181818181818,50.31818181818182
267,44,35,9,7,37,163,206,29.045454545454547,12.925348455646224,39.08173197712153,50.43181818181818,49.56818181818182
268,42,34,8,6,36,165,206,28.952380952380953,11.207606476399715,38.55490837946011,49.95238095238095,50.04761904761905
269,44,34,10,6,38,165,206,28.636363636363637,12.905992502545706,38.07128022472702,51.22727272727273,48.77272727272727
270,43,32,11,5,38,167,206,27.651162790697676,13.107929249944299,35.938582377962675,51.2093023255814,48.7906976744186
271,44,32,12,7,37,167,206,28.022727272727273,13.544682218977067,36.568954144659294,51.18181818181818,48.81818181818182
272,44,32,12,7,37,167,206,29.022727272727273,14.460970820158927,34.51630190711381,51.18181818181818,48.81818181818182
273,44,31,13,7,37,168,206,28.59090909090909,14.729088616349431,35.589093201832384,51.02272727272727,48.97727272727273
274,44,29,15,9,35,170,206,27.227272727272727,14.970750672169675,37.16552481630859,49.59090909090909,50.40909090909091
275,44,30,14,9,35,171,206,26.65909090909091,15.342441332637696,36.88483139463503,49.52272727272727,50.47727272727273
276,45,29,16,9,36,172,206,25.866666666666667,15.950054245728733,36.027723532049045,49.6,50.4
277,44,28,16,8,36,174,206,25.136363636363637,16.545692677306054,34.362760828032485,50.61363636363637,49.38636363636363
278,43,27,16,8,35,175,206,25.488372093023255,16.470331399116105,32.64594767065134,50.23255813953488,49.76744186046512
279,44,30,14,8,36,175,206,25.90909090909091,16.7433287819179,33.188489399900284,51.18181818181818,48.81818181818182
280,43,29,14,9,34,176,206,26.13953488372093,16.362340829188888,32.54463591499716,51.604651162790695,48.395348837209305
281,43,30,13,11,32,176,206,27.13953488372093,15.03486475637234,33.8721119878137,51.604651162790695,48.395348837209305
282,45,30,15,11,34,176,206,26.933333333333334,16.334893955391586,36.13177271127508,49.955555555555556,50.044444444444444
283,45,30,15,11,34,177,206,26.755555555555556,16.45751411965261,35.164794291613084,50.62222222222222,49.37777777777778
284,44,29,15,11,33,178,206,27.022727272727273,16.39058575023319,33.654868795221354,50.5,49.5
285,46,30,16,13,33,178,206,26.847826086956523,16.27438571249943,37.37778820054405,49.630434782608695,50.369565217391305
286,48,31,17,15,33,178,206,26.729166666666668,17.686813747268435,35.37568625273156,49.479166666666664,50.520833333333336
287,48,32,16,14,34,179,206,26.666666666666668,17.792982598082016,34.424125131711214,47.833333333333336,52.166666666666664
288,50,32,18,14,36,179,206,26.6,17.971508613410162,34.32849138658983,46.82,53.18
289,51,30,21,14,37,181,206,25.058823529411764,18.98912765649274,34.54028410821314,47.86274509803921,52.13725490196079
290,51,32,19,16,35,181,206,26.058823529411764,19.324970250869583,31.45934347462061,47.86274509803921,52.13725490196079
291,52,34,18,16,36,181,206,26.557692307692307,20.659775154210514,31.994070999635635,48.07692307692308,51.92307692307692
292,53,34,19,17,36,182,207,25.452830188679247,20.719705257721365,33.21321551625509,47.22641509433962,52.77358490566038
293,54,34,20,16,38,183,207,25.037037037037038,21.310083376960254,31.031487012312937,47.629629629629626,52.370370370370374
294,54,33,21,15,39,184,207,24.944444444444443,20.961801873261688,31.85301294155313,47.53703703703704,52.46296296296296
295,55,33,22,15,40,184,207,25.490909090909092,22.267029091910537,31.114789089907646,47.14545454545455,52.85454545454545
296,55,32,23,15,40,184,208,26.09090909090909,21.910475665730438,32.08952433426956,47.63636363636363,52.36363636363637
297,55,31,24,17,38,185,208,26.12727272727273,21.914814975893474,33.772847922217125,46.50909090909091,53.49090909090909
298,54,32,22,17,37,186,209,25.444444444444443,20.92041741840788,36.78328628529582,46.074074074074076,53.925925925925924
299,55,32,23,16,39,187,209,24.945454545454545,21.40226039942471,36.561446482519955,44.85454545454545,55.14545454545455
300,57,30,27,17,40,189,209,23.210526315789473,23.71169409118874,35.632085906001436,44.333333333333336,55.666666666666664
301,58,31,27,16,42,190,209,22.844827586206897,21.888487615203864,36.2494434192789,44.706896551724135,55.293103448275865
302,56,31,25,14,42,192,209,22.571428571428573,22.67805315577098,33.50051827280045,45.25,54.75
303,54,30,24,13,41,194,209,22.37037037037037,21.180720415973614,34.89335365810046,46.425925925925924,53.574074074074076
304,53,31,22,12,41,194,210,22.735849056603772,20.234974240062783,35.654111177193144,45.471698113207545,54.528301886792455
305,52,32,20,11,41,195,210,23.134615384615383,20.419014957548292,35.888677350144015,45.96153846153846,54.03846153846154
306,53,33,20,13,40,195,210,23.69811320754717,19.639407738505067,38.13417716715531,45.509433962264154,54.490566037735846
307,55,34,21,13,42,195,210,23.836363636363636,20.833408460505147,38.312046084949394,46.163636363636364,53.836363636363636
308,57,36,21,15,42,195,210,24.0,22.55473197539883,36.30491714740818,46.75438596491228,53.24561403508772
309,59,39,20,15,44,195,210,24.1864406779661,22.747174982683205,35.60875722070662,46.983050847457626,53.016949152542374
310,62,40,22,17,45,195,210,24.016129032258064,25.103322128735797,32.332161742231946,47.04838709677419,52.95161290322581
311,63,40,23,18,45,196,210,23.603174603174605,25.41692812941132,30.630690918207723,48.23809523809524,51.76190476190476
312,64,39,25,18,46,197,211,22.921875,25.284727844071405,30.867951411536673,48.28125,51.71875
313,63,38,25,18,45,199,211,22.571428571428573,26.214312759922365,28.150766605157,47.507936507936506,52.492063492063494
314,65,38,27,20,45,199,212,22.553846153846155,27.21093672465001,26.91214019842691,48.01538461538462,51.98461538461538
315,66,37,29,19,47,200,213,21.666666666666668,27.705222084395096,26.11295973378672,48.833333333333336,51.166666666666664
316,68,39,29,20,48,200,214,21.235294117647058,28.450001127507043,25.405446242337522,49.11764705882353,50.88235294117647
317,70,43,27,20,50,200,214,21.62857142857143,29.570561844289784,23.858009584281653,50.08571428571429,49.91428571428571
318,69,40,29,19,50,201,216,21.55072463768116,28.255046015998495,23.8753887666102,49.44927536231884,50.55072463768116
319,72,40,32,19,53,201,216,21.65277777777778,29.868882532316448,23.839450801016888,47.958333333333336,52.041666666666664
320,72,39,33,18,54,201,217,21.88888888888889,29.5105794958667,22.364420504133307,46.81944444444444,53.18055555555556
321,72,39,33,18,54,201,217,22.88888888888889,29.79757551087784,21.382980044677716,46.81944444444444,53.18055555555556
322,69,37,32,15,54,204,217,22.652173913043477,31.117973204429482,19.360287665135736,46.84057971014493,53.15942028985507
323,70,36,34,15,55,204,218,22.642857142857142,31.403146801719426,21.66828176970914,47.92857142857143,52.07142857142857
324,71,39,32,15,56,205,218,22.52112676056338,30.930413844808218,21.858318549557985,47.95774647887324,52.04225352112676
325,71,38,33,14,57,206,220,21.830985915492956,30.410914239598203,21.960880620936834,48.929577464788736,51.070422535211264
326,72,39,33,15,57,206,221,21.833333333333332,30.75159512968645,22.887690939211875,48.125,51.875
327,71,39,32,14,57,207,224,21.380281690140844,29.1251178478162,24.890212322919215,49.70422535211268,50.29577464788732
328,72,40,32,14,58,207,225,21.5,29.025473888955144,24.543970555489302,49.93055555555556,50.06944444444444
329,72,42,30,14,58,207,226,22.27777777777778,29.729552513518726,23.79822526425905,49.875,50.125
330,73,43,30,14,59,207,227,22.753424657534246,31.272953297104337,22.631156291936765,49.93150684931507,50.06849315068493
331,71,45,26,14,57,207,229,23.95774647887324,29.547422433364492,23.297647989170724,49.985915492957744,50.014084507042256
332,71,46,25,14,57,207,229,24.95774647887324,30.13450718830473,22.851408304653017,49.985915492957744,50.014084507042256
333,71,45,26,14,57,207,231,24.788732394366196,29.900909980130763,25.141343540996004,49.732394366197184,50.267605633802816
334,70,45,25,12,58,209,232,24.057142857142857,30.5388136962114,24.10404344664574,49.77142857142857,50.22857142857143
335,68,45,23,13,55,210,233,24.720588235294116,29.523867426726795,23.34143013899162,50.838235294117645,49.161764705882355
336,70,47,23,13,57,210,233,25.014285714285716,31.38842442368455,22.311575576315448,50.97142857142857,49.02857142857143
337,69,45,24,13,56,210,235,25.115942028985508,30.778718654647385,22.68504946129464,52.028985507246375,47.971014492753625
338,65,41,24,10,55,213,237,24.138461538461538,28.5145031267448,25.264085318589075,53.47692307692308,46.52307692307692
339,62,38,24,10,52,215,238,24.225806451612904,25.323508309579694,27.659026116200053,54.096774193548384,45.903225806451616
340,64,40,24,12,52,215,238,24.46875,26.34319276791728,27.89118223208272,54.453125,45.546875
341,64,42,22,11,53,216,238,24.65625,27.283702551432235,26.394499516012917,53.796875,46.203125
342,62,42,20,9,53,217,239,24.806451612903224,27.12877237054854,24.663922090231644,53.983870967741936,46.016129032258064
343,62,41,21,9,53,217,240,25.129032258064516,26.599401037100105,27.006875855963628,54.20967741935484,45.79032258064516
344,65,47,18,11,54,217,240,24.96923076923077,27.232188220685565,27.16781177931443,53.44615384615385,46.55384615384615
345,65,46,19,10,55,219,240,24.2,29.780866899998216,23.8229015798611,53.47692307692308,46.52307692307692
346,68,48,20,10,58,219,240,24.13235294117647,31.120411305158026,22.23252987131256,53.55882352941177,46.44117647058823
347,68,47,21,10,58,219,241,24.83823529411765,32.90877867119077,18.841221328809233,54.470588235294116,45.529411764705884
348,67,45,22,9,58,220,243,24.582089552238806,33.339229897219504,17.67569547591482,54.82089552238806,45.17910447761194
349,65,40,25,8,57,221,247,23.415384615384614,31.04601086622118,21.01544927608045,56.246153846153845,43.753846153846155
350,63,40,23,12,51,221,250,24.126984126984127,29.931572959504784,20.100987453366166,57.84126984126984,42.15873015873016
351,64,40,24,12,52,221,250,24.75,31.937852760673792,18.42152223932621,58.0625,41.9375
352,66,40,26,12,54,221,251,24.71212121212121,34.418216518506405,16.930268329978446,57.81818181818182,42.18181818181818
353,63,37,26,11,52,222,255,23.73015873015873,31.269035458720875,19.83439687226309,58.42857142857143,41.57142857142857
354,61,35,26,11,50,223,257,24.049180327868854,32.14605560343103,16.985091937552575,58.01639344262295,41.98360655737705
355,58,33,25,12,46,223,260,24.96551724137931,30.81228736375274,17.729864321837937,58.93103448275862,41.06896551724138
356,58,33,25,12,46,224,260,25.0,32.52318058161197,17.436977458413914,58.706896551724135,41.293103448275865
357,57,32,25,12,45,224,263,25.56140350877193,28.094029729435707,22.60805832446907,57.89473684210526,42.10526315789474
358,54,29,25,9,45,225,265,25.314814814814813,24.45315921210025,25.84834708706305,58.5,41.5
359,53,28,25,9,44,226,266,25.339622641509433,23.239267781581667,26.86919293937268,58.16981132075472,41.83018867924528
360,56,29,27,9,47,226,266,24.982142857142858,25.227332755934096,28.326238672637334,58.05357142857143,41.94642857142857
361,54,30,24,8,46,228,266,24.98148148148148,26.19801153234551,24.02421068987671,57.129629629629626,42.870370370370374
362,55,31,24,8,47,229,266,24.6,26.863350827916793,25.53664917208321,57.78181818181818,42.21818181818182
363,54,31,23,7,47,231,266,24.037037037037038,29.435094540800005,21.06934090812303,58.111111111111114,41.888888888888886
364,54,31,23,7,47,231,266,25.037037037037038,30.639381721804018,19.15691457449228,58.111111111111114,41.888888888888886
365,51,31,20,9,42,232,268,25.80392156862745,27.46964877579762,21.99708137138665,57.450980392156865,42.549019607843135
366,50,31,19,8,42,234,268,25.26,25.300796037085803,26.039203962914197,56.12,43.88
367,51,32,19,8,43,234,269,24.784313725490197,25.942499022230518,25.270873951323125,55.568627450980394,44.431372549019606
368,51,34,17,10,41,235,269,24.784313725490197,27.205089041256887,22.435807052657815,54.411764705882355,45.588235294117645
369,52,34,18,10,42,236,269,24.173076923076923,26.896450777344548,24.79585691496315,54.73076923076923,45.26923076923077
370,53,35,18,12,41,237,269,23.735849056603772,26.686075443470045,25.93656606596392,54.64150943396226,45.35849056603774
371,53,34,19,11,42,238,269,23.77358490566038,27.358078669515805,23.16088845749497,55.528301886792455,44.471698113207545
372,55,34,21,13,42,238,269,23.90909090909091,28.545481391601243,23.545427699307844,54.29090909090909,45.70909090909091
373,53,33,20,13,40,239,270,24.41509433962264,28.528973203151036,22.584234344018775,55.320754716981135,44.679245283018865
374,48,28,20,13,35,241,273,24.291666666666668,24.431110252271996,25.030521984188937,55.291666666666664,44.708333333333336
375,49,30,19,15,34,241,273,24.79591836734694,23.044831588996427,27.955168411003573,54.48979591836735,45.51020408163265
376,48,31,17,15,33,242,273,25.25,24.067331899912293,24.932668100087707,54.104166666666664,45.895833333333336
377,49,31,18,15,34,242,274,25.183673469387756,24.089271681972548,26.673538078063245,53.55102040816327,46.44897959183673
378,49,31,18,14,35,243,275,24.6734693877551,23.57176901723849,26.877210574598244,53.44897959183673,46.55102040816327
379,51,32,19,20,31,243,275,24.705882352941178,23.900555765712753,25.47199325389509,54.745098039215684,45.254901960784316
380,52,30,22,18,34,245,276,22.596153846153847,23.94199734101938,26.00031035128831,57.17307692307692,42.82692307692308
381,54,28,26,17,37,247,276,20.796296296296298,26.235123999865372,24.615250762007527,56.111111111111114,43.888888888888886
382,55,29,26,17,38,247,276,21.418181818181818,27.841656034961414,19.90379851049313,56.0,44.0
383,54,27,27,16,38,248,277,21.333333333333332,28.696488713594924,18.5257335086273,56.148148148148145,43.851851851851855
384,57,29,28,16,41,248,277,21.210526315789473,30.663774523876107,16.31868161647477,56.54385964912281,43.45614035087719
385,57,31,26,17,40,249,277,21.19298245614035,29.98480150741625,15.716952878548659,55.89473684210526,44.10526315789474
386,56,29,27,16,40,250,279,20.982142857142858,28.72426495462856,19.883028755831383,55.392857142857146,44.607142857142854
387,56,28,28,16,40,250,282,20.946428571428573,25.986077946002712,23.038453258564555,56.80357142857143,43.19642857142857
388,55,27,28,17,38,251,283,20.90909090909091,25.263463429652216,20.552934918704544,56.81818181818182,43.18181818181818
389,55,27,28,17,38,251,284,21.545454545454547,24.31838986171669,22.299791956465125,56.67272727272727,43.32727272727273
390,55,27,28,17,38,251,284,22.545454545454547,24.79418853541104,20.914902373679876,56.67272727272727,43.32727272727273
391,56,26,30,16,40,252,284,22.017857142857142,26.78250562984311,20.11035151301403,56.19642857142857,43.80357142857143
392,57,24,33,15,42,252,287,21.17543859649123,24.225416053606438,24.721952367446193,57.526315789473685,42.473684210526315
393,58,26,32,15,43,252,287,21.810344827586206,24.181919359700434,22.593942709265086,56.55172413793103,43.44827586206897
394,61,27,34,15,46,252,287,21.737704918032787,27.051651675551167,21.571299144120964,55.721311475409834,44.278688524590166
395,62,28,34,15,47,252,287,22.387096774193548,29.769033827346192,16.585804882331228,56.016129032258064,43.983870967741936
396,62,30,32,14,48,252,290,21.516129032258064,27.987218032970254,20.54504003154588,54.935483870967744,45.064516129032256
397,60,31,29,11,49,254,291,20.633333333333333,26.96485287218167,20.782048877418976,53.983333333333334,46.016666666666666
398,61,33,28,11,50,254,291,21.295081967213115,27.484611335077933,20.61374932065977,53.31147540983606,46.68852459016394
399,61,33,28,11,50,255,291,21.229508196721312,29.199439409651383,18.587445836250257,52.950819672131146,47.049180327868854
400,61,34,27,12,49,256,291,21.34426229508197,30.509287834214597,17.293990854309992,53.14754098360656,46.85245901639344
401,62,34,28,14,48,256,292,21.693548387096776,30.201320491250943,17.86784924910462,52.88709677419355,47.11290322580645
402,60,34,26,13,47,257,294,21.85,28.519085306874118,19.858876215540146,52.35,47.65
403,56,30,26,12,44,258,298,22.142857142857142,23.97698569277295,25.13015716436991,52.55357142857143,47.44642857142857
404,55,32,23,12,43,259,298,22.563636363636363,24.498042266382527,23.57281191860453,51.836363636363636,48.163636363636364
405,53,31,22,11,42,260,299,22.962264150943398,23.755946569712453,25.168581732174346,51.886792452830186,48.113207547169814
406,54,30,24,13,41,260,300,23.203703703703702,22.992203944408057,28.54483309262898,49.648148148148145,50.351851851851855
407,52,30,22,13,39,260,302,24.25,20.291249885925716,30.574134729458898,49.69230769230769,50.30769230769231
408,52,32,20,13,39,260,303,24.903846153846153,19.717295520447877,33.03270447955212,49.67307692307692,50.32692307692308
409,54,34,20,13,41,260,303,24.98148148148148,21.347009583313937,32.282620046315685,49.98148148148148,50.01851851851852
410,52,34,18,11,41,262,303,24.807692307692307,20.70102377763608,30.625899299286996,49.32692307692308,50.67307692307692
411,51,34,17,10,41,263,303,25.254901960784313,18.52889551280314,33.62796723229491,48.86274509803921,51.13725490196079
412,51,37,14,10,41,263,303,26.254901960784313,18.53703805552433,33.81590312094626,48.86274509803921,51.13725490196079
413,51,37,14,12,39,264,303,26.235294117647058,18.756279281073045,33.2633285620642,49.3921568627451,50.6078431372549
414,55,38,17,12,43,264,303,25.327272727272728,20.234581823134654,34.07450908595625,49.78181818181818,50.21818181818182
415,52,37,15,10,42,267,303,24.826923076923077,19.38157100278198,30.450096075293178,49.38461538461539,50.61538461538461
416,50,35,15,8,42,269,304,23.94,17.899333540814084,32.20066645918591,49.6,50.4
417,50,35,15,8,42,269,304,24.94,16.788595126141544,32.71140487385845,49.6,50.4
418,52,38,14,10,42,269,304,24.98076923076923,18.69532040241419,32.72775652066274,49.94230769230769,50.05769230769231
419,51,38,13,10,41,270,304,25.11764705882353,19.20134582942448,29.366477954422407,49.07843137254902,50.92156862745098
420,52,37,15,10,42,271,304,24.634615384615383,19.382005195695942,31.444917881227134,49.07692307692308,50.92307692307692
421,52,37,15,10,42,271,304,25.634615384615383,19.440430722977013,29.655723123176834,49.07692307692308,50.92307692307692
422,53,38,15,12,41,271,304,26.150943396226417,20.372137673123383,30.4769189306502,48.905660377358494,51.094339622641506
423,53,39,14,12,41,271,304,27.150943396226417,20.635983020235038,29.269677357123452,48.905660377358494,51.094339622641506
424,53,39,14,12,41,272,304,27.169811320754718,19.20706176574801,32.58539106444067,48.35849056603774,51.64150943396226
425,53,39,14,11,42,273,304,27.18867924528302,19.990827619611963,31.2852807696336,49.264150943396224,50.735849056603776
426,55,40,15,13,42,273,304,27.2,19.75615560951184,33.35293529957907,48.07272727272727,51.92727272727273
427,59,40,19,13,46,273,304,26.35593220338983,21.764333275770213,32.218717571687414,48.11864406779661,51.88135593220339
428,58,39,19,13,45,274,304,26.93103448275862,22.929434357566997,27.898151849329555,48.672413793103445,51.327586206896555
429,59,38,21,14,45,275,304,26.593220338983052,24.12157993828085,29.86147090917678,48.728813559322035,51.271186440677965
430,61,43,18,14,47,275,304,26.721311475409838,25.022860182983763,28.82959883340968,48.442622950819676,51.557377049180324
431,59,41,18,15,44,277,304,26.83050847457627,24.835802187974306,28.096427996980676,47.86440677966102,52.13559322033898
432,60,42,18,15,45,277,304,27.383333333333333,26.42850857599598,27.55482475733735,48.333333333333336,51.666666666666664
433,62,42,20,15,47,277,304,27.5,28.222977230790374,27.22863567243543,49.483870967741936,50.516129032258064
434,60,42,18,14,46,279,304,27.65,28.695618221052936,25.45438177894707,48.666666666666664,51.333333333333336
435,61,40,21,14,47,279,306,27.065573770491802,26.647088385543295,32.91028866363703,47.98360655737705,52.01639344262295
436,58,38,20,12,46,281,307,26.603448275862068,23.91819743380281,32.63446939639611,46.63793103448276,53.36206896551724
437,55,35,20,9,46,283,309,25.854545454545455,20.700760542878253,36.74408469717125,48.18181818181818,51.81818181818182
438,55,35,20,9,46,283,310,26.2,20.522878160055768,40.07387564714575,48.0,52.0
439,52,31,21,10,42,285,312,25.307692307692307,17.755536727919498,44.1956170613923,48.90384615384615,51.09615384615385
440,52,31,21,9,43,286,312,25.26923076923077,17.76030016195189,43.66277676112504,48.11538461538461,51.88461538461539
441,52,31,21,11,41,287,312,25.096153846153847,17.37724083430886,44.41122070415268,47.94230769230769,52.05769230769231
442,55,33,22,11,44,287,312,24.727272727272727,19.96199774046129,41.656184077720525,49.45454545454545,50.54545454545455
443,56,35,21,13,43,287,312,25.285714285714285,21.965214643780307,37.80264249907684,48.892857142857146,51.107142857142854
444,54,34,20,12,42,289,312,25.27777777777778,21.841986865177336,37.05675627204574,50.2962962962963,49.7037037037037
445,55,35,20,12,43,290,312,24.89090909090909,22.58184890581823,38.890878366909035,50.72727272727273,49.27272727272727
446,54,35,19,13,41,291,313,24.75925925925926,19.316233088200537,42.64547319760873,50.72222222222222,49.27777777777778
447,51,33,18,12,39,293,314,24.50980392156863,17.32894502755496,44.161251050876416,51.0,49.0
448,51,33,18,12,39,294,314,24.41176470588235,16.500687529222965,46.5749310450636,50.35294117647059,49.64705882352941
449,51,33,18,12,39,294,314,25.41176470588235,16.129755764974906,46.438871686005484,50.35294117647059,49.64705882352941
450,50,33,17,12,38,296,314,24.72,17.23208516152316,46.067914838476845,50.8,49.2
451,49,32,17,12,37,298,314,24.06122448979592,18.058516348268174,43.75781018234407,50.755102040816325,49.244897959183675
452,49,34,15,14,35,298,314,25.06122448979592,18.680362435207336,42.319637564792664,50.755102040816325,49.244897959183675
453,48,34,14,13,35,299,314,25.520833333333332,18.419724487151914,41.934442179514754,50.9375,49.0625
454,48,34,14,12,36,300,314,25.375,17.814316838483276,41.72725574396722,52.229166666666664,47.770833333333336
455,48,34,14,12,36,300,314,26.375,15.761847765152519,43.36315223484748,52.229166666666664,47.770833333333336
456,48,33,15,11,37,302,314,24.854166666666668,15.932686694216764,45.6089799724499,53.583333333333336,46.416666666666664
457,49,35,14,11,38,302,314,25.346938775510203,15.84646543684844,43.68414680804951,54.46938775510204,45.53061224489796
458,49,37,12,13,36,302,314,26.346938775510203,15.165063666152028,43.34514041548063,54.46938775510204,45.53061224489796
459,50,38,12,13,37,302,314,26.82,16.421813360270054,42.73818663972994,54.04,45.96
460,50,39,11,13,37,302,314,27.82,16.325545389380398,41.8344546106196,54.04,45.96
461,51,40,11,15,36,302,314,28.274509803921568,16.522750471885207,41.810582861448125,53.27450980392157,46.72549019607843
462,52,41,11,15,37,302,314,28.73076923076923,16.674307849266867,41.99876907381005,53.75,46.25
463,54,42,12,15,39,302,314,28.666666666666668,18.549298972338104,40.76551584247672,53.7962962962963,46.2037037037037
464,53,42,11,14,39,303,314,29.245283018867923,18.489411551097653,39.79360731682687,53.113207547169814,46.886792452830186
465,53,42,11,14,39,303,314,30.245283018867923,18.713583726778083,39.56943514114644,53.113207547169814,46.886792452830186
466,53,41,12,12,41,305,314,29.18867924528302,19.69129355678935,37.88428891230311,52.509433962264154,47.490566037735846
467,56,41,15,14,42,306,314,27.714285714285715,20.651473136452342,35.759241149261946,53.535714285714285,46.464285714285715
468,58,41,17,14,44,306,314,27.75862068965517,21.29175544958505,33.96686524007012,52.08620689655172,47.91379310344828
469,59,40,19,14,45,307,314,27.35593220338983,21.956143728825342,33.85741559320855,50.79661016949152,49.20338983050848
470,58,39,19,15,43,308,315,26.844827586206897,20.024261018486236,35.80845299158871,49.724137931034484,50.275862068965516
471,60,39,21,17,43,308,315,26.95,21.288313505965142,35.561686494034866,49.833333333333336,50.166666666666664
472,59,40,19,16,43,309,315,27.47457627118644,21.6034796015393,33.3965203984607,49.644067796610166,50.355932203389834
473,62,41,21,16,46,309,315,27.14516129032258,22.898370270084012,35.03711360088373,49.306451612903224,50.693548387096776
474,61,40,21,15,46,310,315,27.75409836065574,23.752701660410754,31.493199978933507,49.622950819672134,50.377049180327866
475,62,41,21,15,47,310,315,28.306451612903224,24.023424719612304,31.734639796516728,49.46774193548387,50.53225806451613
476,60,38,22,15,45,312,316,27.9,23.760762756031962,30.112867958296533,50.05,49.95
477,58,36,22,14,44,314,316,27.844827586206897,24.505023170591784,29.08118372595994,50.06896551724138,49.93103448275862
478,57,35,22,13,44,315,317,27.42105263157895,23.59477186115076,30.19470182305977,50.40350877192982,49.59649122807018
479,56,36,20,13,43,316,318,27.303571428571427,21.356576517533995,31.71485205389457,50.44642857142857,49.55357142857143
480,53,32,21,12,41,319,319,26.09433962264151,21.115038826522948,34.44179577603598,50.716981132075475,49.283018867924525
481,54,32,22,12,42,319,319,26.61111111111111,22.095974846015107,33.718839968799706,50.51851851851852,49.48148148148148
482,54,32,22,11,43,320,319,26.574074074074073,23.04313043850155,32.13678900006242,50.51851851851852,49.48148148148148
483,55,37,18,11,44,320,319,27.09090909090909,24.04528687798524,31.75471312201476,50.69090909090909,49.30909090909091
484,54,37,17,13,41,321,320,27.0,24.067180568255115,32.8821281242932,51.2037037037037,48.7962962962963
485,54,36,18,13,41,321,321,27.27777777777778,23.95202071429878,33.19612743384937,50.388888888888886,49.611111111111114
486,55,37,18,12,43,322,321,26.727272727272727,25.73841643330171,31.3706744757892,51.654545454545456,48.345454545454544
487,52,36,16,11,41,325,322,25.692307692307693,25.354869216029446,29.450266162371936,50.03846153846154,49.96153846153846
488,50,33,17,9,41,326,324,25.22,23.824504292525752,29.567708102928567,49.38,50.62
489,49,34,15,9,40,326,325,26.26530612244898,22.575922945502786,30.219995421844153,49.51020408163265,50.48979591836735
490,47,33,14,8,39,328,325,26.02127659574468,19.431154943655827,32.143313141450555,51.0,49.0
491,46,32,14,8,38,328,326,26.782608695652176,17.627173424294984,34.438043967009364,49.95652173913044,50.04347826086956
492,45,32,13,7,38,329,326,26.91111111111111,16.491693146054573,36.72974507993115,49.62222222222222,50.37777777777778
493,43,31,12,9,34,331,326,26.27906976744186,16.51887660362166,34.955639000843064,49.18604651162791,50.81395348837209
494,43,31,12,8,35,332,326,25.953488372093023,16.168534275021965,35.81896339939664,48.674418604651166,51.325581395348834
495,41,30,11,6,35,334,326,25.4390243902439,14.31622359998009,34.95980829858834,48.73170731707317,51.26829268292683
496,41,31,10,6,35,334,326,26.4390243902439,12.58769979362696,36.94888557222669,48.73170731707317,51.26829268292683
497,42,32,10,6,36,334,326,26.80952380952381,13.463566762827167,36.53643323717283,49.23809523809524,50.76190476190476
498,42,32,10,9,33,335,326,26.452380952380953,13.78811953671042,34.90235665376578,49.45238095238095,50.54761904761905
499,44,33,11,9,35,335,326,26.25,15.348404942535113,34.992504148373975,50.61363636363637,49.38636363636363
500,44,34,10,9,35,335,326,27.25,14.247549637199882,33.82063218098193,50.61363636363637,49.38636363636363
501,44,33,11,8,36,337,326,25.818181818181817,16.239896566405196,33.78283070632207,48.68181818181818,51.31818181818182
502,45,35,10,8,37,337,326,26.244444444444444,16.444429033817986,31.644459855070902,48.044444444444444,51.955555555555556
503,46,36,10,12,34,337,326,26.67391304347826,15.686819099474834,31.595789596177344,48.0,52.0
504,46,35,11,11,35,339,326,25.08695652173913,16.135144600596774,32.32175751634627,48.06521739130435,51.93478260869565
505,50,35,15,13,37,339,326,24.08,19.004660440848305,30.495339559151695,49.32,50.68
506,51,35,16,15,36,339,326,24.607843137254903,18.390750382324196,27.90336726473463,50.13725490196079,49.86274509803921
507,51,35,16,15,36,339,326,25.607843137254903,18.091465369026032,27.222260121170045,50.13725490196079,49.86274509803921
508,52,35,17,15,37,339,326,26.115384615384617,19.110644364574213,26.908586404656553,49.92307692307692,50.07692307692308
509,52,35,17,15,37,339,326,27.115384615384617,19.32590845751318,25.731783850179127,49.92307692307692,50.07692307692308
510,54,35,19,15,39,339,326,27.11111111111111,21.20950301604309,26.957163650623574,51.351851851851855,48.648148148148145
511,53,34,19,14,39,341,326,26.566037735849058,20.296319381635517,25.865274411822295,51.735849056603776,48.264150943396224
512,54,34,20,16,38,341,326,27.074074074074073,20.58650578906574,26.006086803526856,51.03703703703704,48.96296296296296
513,53,33,20,16,37,343,326,26.660377358490567,21.43000944137248,23.17376414353318,49.943396226415096,50.056603773584904
514,57,33,24,18,39,343,326,25.789473684210527,22.763953899233044,22.622011013047658,48.64912280701754,51.35087719298246
515,61,35,26,18,43,344,326,24.24590163934426,23.579178493004513,23.151324746984365,49.377049180327866,50.622950819672134
516,60,33,27,16,44,345,327,24.016666666666666,22.98110897723843,20.745930592640907,49.983333333333334,50.016666666666666
517,60,33,27,16,44,346,327,24.15,24.717012885815148,19.61632044751819,49.583333333333336,50.416666666666664
518,63,35,28,16,47,346,327,24.0,27.336392630069174,17.520750227073684,48.698412698412696,51.301587301587304
519,66,36,30,16,50,346,327,23.90909090909091,29.222739683659903,16.625745164824945,49.36363636363637,50.63636363636363
520,65,35,30,15,50,347,328,23.846153846153847,28.598517041687646,15.157512260421768,49.56923076923077,50.43076923076923
521,63,37,26,15,48,348,330,23.746031746031747,27.177503943033678,17.781859466595446,49.98412698412698,50.01587301587302
522,61,35,26,15,46,350,331,23.19672131147541,26.89233438549726,18.4450690859791,50.540983606557376,49.459016393442624
523,59,33,26,14,45,351,332,23.45762711864407,25.85988111752408,19.61469515366236,50.186440677966104,49.813559322033896
524,60,32,28,14,46,351,334,23.25,25.352555947819248,25.18293523415724,51.733333333333334,48.266666666666666
525,57,29,28,11,46,354,334,22.57894736842105,26.769403880764923,20.521479041194965,52.40350877192982,47.59649122807018
526,56,28,28,10,46,355,335,22.5,25.392498997642395,22.321786716643317,53.0,47.0
527,51,25,26,10,41,358,337,21.431372549019606,23.512145238106346,25.458782504278155,51.80392156862745,48.19607843137255
528,49,24,25,9,40,359,338,21.693877551020407,21.74881196900638,26.475670565717955,51.51020408163265,48.48979591836735
529,47,23,24,10,37,360,339,21.893617021276597,20.506900791248828,28.452355386507055,51.829787234042556,48.170212765957444
530,46,24,22,9,37,361,339,22.23913043478261,20.647267705013725,26.71923209138405,52.28260869565217,47.71739130434783
531,46,28,18,9,37,361,339,23.23913043478261,21.417467087469216,27.060793782096,52.28260869565217,47.71739130434783
532,47,31,16,9,38,361,339,23.74468085106383,20.705553806409227,28.549765342526943,51.276595744680854,48.723404255319146
533,46,32,14,8,38,362,339,24.08695652173913,19.06010925982218,28.113803783656078,50.32608695652174,49.67391304347826
534,45,33,12,9,36,364,339,23.0,17.925810555967182,26.8789798431207,51.15555555555556,48.84444444444444
535,46,34,12,11,35,364,339,23.5,18.937181034774138,27.88890592174761,50.82608695652174,49.17391304347826
536,45,35,10,10,35,365,339,23.8,20.537274566678246,25.129392099988415,51.06666666666667,48.93333333333333
537,45,36,9,9,36,366,339,23.644444444444446,21.172670678217973,27.027329321782034,51.62222222222222,48.37777777777778
538,46,37,9,9,37,366,339,24.130434782608695,21.93928410632299,26.517237632807436,52.54347826086956,47.45652173913044
539,46,37,9,9,37,366,339,25.130434782608695,21.276597303992354,26.092967913398954,52.54347826086956,47.45652173913044
540,43,36,7,7,36,368,340,24.488372093023255,19.675118434272644,26.813253658750604,53.604651162790695,46.395348837209305
541,44,37,7,7,37,368,340,24.931818181818183,19.886741887995633,28.635985384731644,53.52272727272727,46.47727272727273
542,43,37,6,8,35,369,340,25.186046511627907,20.26025254538837,26.13238244850906,53.02325581395349,46.97674418604651
543,44,37,7,10,34,369,340,25.613636363636363,19.846871726123876,28.425855546603394,53.11363636363637,46.88636363636363
544,44,36,8,10,34,369,341,25.65909090909091,19.164702069224948,29.40397920600642,53.72727272727273,46.27272727272727
545,45,36,9,10,35,369,341,26.08888888888889,19.912160057811505,28.421173275521827,53.955555555555556,46.044444444444444
546,47,36,11,10,37,369,341,25.97872340425532,21.122343847584286,28.920209343905075,53.40425531914894,46.59574468085106
547,47,36,11,10,37,369,341,26.97872340425532,22.121623312925415,25.793270304095863,53.40425531914894,46.59574468085106
548,51,37,14,10,41,369,341,25.862745098039216,24.109303431251465,28.224029902081874,55.8235294117647,44.1764705882353
549,52,37,15,10,42,369,341,26.365384615384617,24.771213869995208,24.459555360774022,54.82692307692308,45.17307692307692
550,53,38,15,10,43,369,341,26.867924528301888,26.26813087229494,23.788472901289964,54.075471698113205,45.924528301886795
551,56,39,17,10,46,369,341,26.428571428571427,26.995119126473178,23.058452302098257,53.57142857142857,46.42857142857143
552,56,38,18,9,47,370,341,26.517857142857142,29.10900798032023,19.105277733965487,52.642857142857146,47.357142857142854
553,56,38,18,8,48,370,342,26.821428571428573,28.92573009992223,19.752841328649197,52.642857142857146,47.357142857142854
554,55,37,18,7,48,370,343,27.581818181818182,30.181315586257895,17.73398539116394,52.78181818181818,47.21818181818182
555,55,37,18,7,48,371,343,27.636363636363637,31.80499635604401,16.18099022343357,54.018181818181816,45.981818181818184
556,54,35,19,8,46,371,345,27.59259259259259,30.823015574266364,18.917725166474376,53.5,46.5
557,55,36,19,8,47,371,345,28.09090909090909,30.491776718773764,20.25367782668077,54.27272727272727,45.72727272727273
558,53,34,19,7,46,372,346,28.32075471698113,29.52508023806135,19.659415573272216,53.64150943396226,46.35849056603774
559,53,34,19,7,46,372,347,28.50943396226415,30.037195085486914,20.59517215380711,53.22641509433962,46.77358490566038
560,51,32,19,7,44,373,349,27.980392156862745,28.882114375602068,23.7845522910646,53.23529411764706,46.76470588235294
561,50,30,20,10,40,373,351,27.76,27.090353528614024,25.827286904410695,52.74,47.26
562,51,30,21,10,41,375,351,26.098039215686274,29.29441874536605,25.09454111483423,54.568627450980394,45.431372549019606
563,49,29,20,9,40,376,352,26.102040816326532,28.74508046293537,23.583394625927696,53.97959183673469,46.02040816326531
564,48,29,19,8,40,378,352,25.3125,29.219428854576094,24.384737812090574,52.125,47.875
565,47,28,19,7,40,379,352,25.76595744680851,24.61440290463352,28.154064719808265,52.829787234042556,47.170212765957444
566,47,30,17,11,36,379,353,25.76595744680851,21.707505859827638,33.52653669336385,52.744680851063826,47.255319148936174
567,43,29,14,9,34,383,353,24.0,20.823166736355805,33.33903793069055,54.48837209302326,45.51162790697674
568,43,31,12,9,34,383,353,25.0,21.01004855242552,34.31553284292332,54.48837209302326,45.51162790697674
569,44,32,12,9,35,383,353,25.431818181818183,19.90057817592343,35.667603642258385,54.29545454545455,45.70454545454545
570,43,30,13,9,34,385,353,24.651162790697676,18.417509604677825,35.90279096588121,54.0,46.0
571,43,31,12,9,34,385,353,25.651162790697676,16.554049517738818,37.538973738075136,54.0,46.0
572,43,31,12,9,34,385,353,26.651162790697676,16.76665839908977,37.32636485672418,54.0,46.0
573,42,29,13,10,32,387,353,25.80952380952381,18.501493549966195,34.78422073574809,52.833333333333336,47.166666666666664
574,44,30,14,14,30,387,353,25.636363636363637,18.93442737806855,35.88375444011327,51.88636363636363,48.11363636363637
575,44,32,12,14,30,387,353,26.636363636363637,17.296244650088287,35.249209895366256,51.88636363636363,48.11363636363637
576,47,33,14,14,33,387,353,25.93617021276596,18.980552701026696,36.083277086207346,50.744680851063826,49.255319148936174
577,48,33,15,13,35,388,353,25.104166666666668,19.550787016015096,33.92733600897339,52.208333333333336,47.791666666666664
578,49,35,14,13,36,389,353,24.428571428571427,19.860980809205085,33.849225254895536,52.30612244897959,47.69387755102041
579,49,34,15,13,36,390,353,24.3265306122449,21.03993606967377,30.551900665020106,51.673469387755105,48.326530612244895
580,50,35,15,13,37,390,353,24.84,23.17790395248453,29.56209604751547,52.34,47.66
581,51,35,16,13,38,390,353,25.352941176470587,23.58818208841598,28.843190460603626,51.78431372549019,48.21568627450981
582,52,35,17,13,39,391,353,24.884615384615383,22.890879787102662,31.51296636674349,51.13461538461539,48.86538461538461
583,51,33,18,11,40,392,354,24.50980392156863,23.46860299828263,31.688259746815408,50.90196078431372,49.09803921568628
584,52,33,19,11,41,392,354,25.03846153846154,24.239190019507593,31.491579211261637,51.34615384615385,48.65384615384615
585,50,31,19,9,41,392,356,25.44,21.80578064632764,32.85421935367236,50.04,49.96
586,50,33,17,9,41,392,356,26.44,22.04280800162724,32.61719199837276,50.04,49.96
587,49,31,18,9,40,394,356,25.693877551020407,22.724597860248334,31.210851524888664,50.08163265306123,49.91836734693877
588,47,29,18,8,39,395,357,25.74468085106383,21.138912136279686,31.520662331805426,49.40425531914894,50.59574468085106
589,46,29,17,8,38,395,358,26.08695652173913,18.02571392539263,36.030178687536555,49.41304347826087,50.58695652173913
590,47,31,16,10,37,395,358,26.53191489361702,18.280947668141426,37.18713743824154,50.340425531914896,49.659574468085104
591,48,31,17,10,38,395,358,26.979166666666668,18.490969663911518,37.842363669421815,49.5,50.5
592,49,33,16,10,39,396,358,26.367346938775512,19.88376072308904,36.9121576442579,50.16326530612245,49.83673469387755
593,47,33,14,12,35,398,358,25.914893617021278,19.956799137155024,34.000647671355615,49.53191489361702,50.46808510638298
594,47,35,12,14,33,398,358,26.914893617021278,19.779053149997537,34.178393658513095,49.53191489361702,50.46808510638298
595,47,36,11,14,33,398,358,27.914893617021278,19.885316013769824,34.07213079474082,49.53191489361702,50.46808510638298
596,48,37,11,14,34,398,358,28.333333333333332,19.313872687837602,35.311127312162405,49.020833333333336,50.979166666666664
597,50,38,12,14,36,398,358,28.2,21.104561453208188,34.43543854679181,49.32,50.68
598,54,38,16,16,38,398,358,27.11111111111111,23.192935008727567,34.89965758386503,48.27777777777778,51.72222222222222
599,53,38,15,16,37,399,359,26.71698113207547,20.50129858525693,33.80954752168639,47.81132075471698,52.18867924528302
600,53,39,14,16,37,399,359,27.71698113207547,19.941005747325764,33.79484330927802,47.81132075471698,52.18867924528302
601,54,40,14,16,38,399,359,28.203703703703702,21.961596036952287,32.79766322230697,48.01851851851852,51.98148148148148
602,54,39,15,17,37,400,359,28.14814814814815,23.757100883924505,31.613269486445866,47.01851851851852,52.98148148148148
603,57,40,17,17,40,400,359,27.666666666666668,25.35928255008934,32.64071744991067,48.35087719298246,51.64912280701754
604,57,38,19,16,41,402,359,26.736842105263158,25.89848002995189,32.1716954086446,47.771929824561404,52.228070175438596
605,57,35,22,13,44,404,360,25.05263157894737,26.65260894288415,31.790247240570718,47.54385964912281,52.45614035087719
606,56,35,21,13,43,404,361,25.696428571428573,26.822751981539223,29.303769817048337,46.69642857142857,53.30357142857143
607,56,34,22,12,44,405,362,24.857142857142858,28.533452627489392,31.555833086796323,47.0,53.0
608,53,32,21,10,43,406,364,24.735849056603772,24.521521949191957,34.79923276778918,47.264150943396224,52.735849056603776
609,52,32,20,10,42,407,364,25.115384615384617,25.421370477116266,33.5401679844222,48.03846153846154,51.96153846153846
610,51,30,21,11,40,409,364,24.568627450980394,26.40362677628634,32.9168155698881,48.333333333333336,51.666666666666664
611,48,27,21,9,39,411,365,24.041666666666668,24.265411009778287,34.364246673979835,49.979166666666664,50.020833333333336
612,46,26,20,8,38,411,367,24.5,20.916945773748335,38.71668004252652,50.130434782608695,49.869565217391305
613,46,26,20,8,38,412,367,24.347826086956523,20.00893040309355,41.96958448834606,50.869565217391305,49.130434782608695
614,46,29,17,8,38,412,367,25.347826086956523,19.221581121580517,41.887114530593394,50.869565217391305,49.130434782608695
615,46,30,16,9,37,414,367,23.695652173913043,20.20133410707803,41.63764572377112,50.30434782608695,49.69565217391305
616,45,28,17,10,35,416,367,22.933333333333334,20.401546571338436,39.351384717456845,50.333333333333336,49.666666666666664
617,45,29,16,10,35,416,367,23.933333333333334,19.285742727420082,39.73647949480214,50.333333333333336,49.666666666666664
618,46,29,17,12,34,416,367,24.41304347826087,19.906175046405423,40.4416510405511,51.26086956521739,48.73913043478261
619,46,31,15,12,34,416,367,25.41304347826087,18.278336879915738,40.98253268530165,51.26086956521739,48.73913043478261
620,48,32,16,14,34,416,367,25.354166666666668,19.132458161397242,43.3258751719361,50.458333333333336,49.541666666666664
621,48,37,11,14,34,416,367,26.354166666666668,19.08825966263201,41.286740337367995,50.458333333333336,49.541666666666664
622,50,38,12,16,34,416,367,26.3,18.712237529193498,42.5677624708065,51.34,48.66
623,51,39,12,15,36,417,367,25.529411764705884,19.332180284352653,43.02076089211794,51.411764705882355,48.588235294117645
624,52,38,14,18,34,418,367,24.98076923076923,20.620791641504283,41.78305199991087,51.78846153846154,48.21153846153846
625,54,38,16,18,36,418,367,25.055555555555557,21.796802024684606,40.795790567907986,52.333333333333336,47.666666666666664
626,54,39,15,20,34,418,367,26.055555555555557,22.11326681081257,38.62747392992818,52.333333333333336,47.666666666666664
627,57,39,18,20,37,418,367,25.68421052631579,26.306969202965778,36.72811851633248,52.63157894736842,47.36842105263158
628,60,39,21,20,40,418,367,25.4,28.520067999759714,33.896598666906954,52.31666666666667,47.68333333333333
629,60,37,23,18,42,420,368,23.9,29.179236853269497,32.43819931875713,49.7,50.3
630,61,35,26,16,45,421,369,22.934426229508198,30.02984555163947,30.363597071311354,50.32786885245902,49.67213114754098
631,62,36,26,16,46,422,369,22.741935483870968,30.977026960444686,28.844572088962767,50.806451612903224,49.193548387096776
632,60,34,26,14,46,422,372,22.433333333333334,27.690666523977686,31.39899406661871,51.36666666666667,48.63333333333333
633,58,31,27,12,46,422,375,22.224137931034484,23.807205786930872,34.52869550064009,51.10344827586207,48.89655172413793
634,58,30,28,12,46,423,376,21.724137931034484,24.556291303984395,35.31046313870103,51.96551724137931,48.03448275862069
635,57,27,30,11,46,425,377,20.50877192982456,24.564207935321164,34.37088978213783,53.3859649122807,46.6140350877193
636,59,29,30,11,48,425,377,20.8135593220339,27.10499689421119,33.75940988544983,54.20338983050848,45.79661016949152
637,59,28,31,14,45,425,378,21.25423728813559,26.27689357243715,31.645725168145685,55.101694915254235,44.898305084745765
638,61,29,32,14,47,425,378,21.557377049180328,28.839317307844432,29.61969908559819,55.24590163934426,44.75409836065574
639,60,30,30,13,47,426,379,21.4,29.151530017464616,28.38745863547138,54.78333333333333,45.21666666666667
640,58,30,28,13,45,426,381,21.93103448275862,25.83131837524354,31.495243690537933,53.672413793103445,46.327586206896555
641,58,29,29,14,44,427,381,21.879310344827587,27.16135285512196,29.99381955867114,54.310344827586206,45.689655172413794
642,56,29,27,14,42,428,382,22.017857142857142,26.73126964369091,29.054444642023373,53.982142857142854,46.017857142857146
643,56,30,26,13,43,429,382,21.982142857142858,26.902393766707814,29.597606233292186,53.625,46.375
644,56,33,23,13,43,429,382,22.982142857142858,26.38735566886316,29.398358616851123,53.625,46.375
645,57,35,22,13,44,429,382,23.57894736842105,25.75789929756003,31.64560947436979,53.824561403508774,46.175438596491226
646,57,40,17,15,42,429,382,24.57894736842105,26.86150600271048,29.664809786763204,53.824561403508774,46.175438596491226
647,56,40,16,15,41,430,383,24.714285714285715,25.605896483557867,30.144103516442133,54.285714285714285,45.714285714285715
648,58,39,19,15,43,431,383,23.603448275862068,26.908359587972765,31.36750248099275,54.8448275862069,45.1551724137931
649,57,40,17,16,41,432,384,23.894736842105264,24.346445482625672,31.860344488600994,54.92982456140351,45.07017543859649
650,58,41,17,16,42,432,384,24.482758620689655,24.065510079898164,33.555179575274245,54.89655172413793,45.10344827586207
651,58,41,17,15,43,433,384,24.56896551724138,24.87595008040041,32.76198095408235,55.43103448275862,44.56896551724138
652,60,45,15,15,45,433,384,24.75,25.966259668928007,31.967073664405326,56.2,43.8
653,60,45,15,15,45,433,384,25.75,25.128808768372462,31.137857898294207,56.2,43.8
654,58,43,15,13,45,436,384,24.862068965517242,26.678662483682377,29.213595632117176,55.741379310344826,44.258620689655174
655,59,44,15,13,46,436,384,25.440677966101696,26.408989899182004,29.506264338106128,55.88135593220339,44.11864406779661
656,58,43,15,12,46,437,385,25.29310344827586,26.034481051845017,28.704673950129745,55.810344827586206,44.189655172413794
657,56,40,16,10,46,438,387,25.035714285714285,23.372253834449104,30.61346843745118,55.089285714285715,44.910714285714285
658,55,39,16,11,44,439,387,25.563636363636363,24.011841329109064,29.26088594361821,55.43636363636364,44.56363636363636
659,55,39,16,10,45,439,389,25.454545454545453,22.00499099020498,33.08591810070411,55.03636363636364,44.96363636363636
660,55,38,17,10,45,440,389,25.527272727272727,22.78607961244903,32.541193114823706,54.32727272727273,45.67272727272727
661,55,38,17,9,46,441,389,25.509090909090908,25.676966998771906,29.835146410435325,54.41818181818182,45.58181818181818
662,53,36,17,8,45,442,390,25.69811320754717,25.04928010884137,28.365814230781275,55.716981132075475,44.283018867924525
663,54,37,17,10,44,442,390,26.22222222222222,25.754170876929013,29.393977271219143,54.75925925925926,45.24074074074074
664,54,39,15,10,44,442,390,27.22222222222222,25.596238114051495,28.625984108170723,54.75925925925926,45.24074074074074
665,56,41,15,10,46,442,390,27.25,25.528563682992267,29.864293459864875,53.80357142857143,46.19642857142857
666,54,39,15,7,47,444,391,26.444444444444443,23.170969974462466,31.43187069248828,53.5,46.5
667,53,39,14,7,46,444,392,27.20754716981132,20.806570526985688,33.55192003905204,53.58490566037736,46.41509433962264
668,52,39,13,9,43,444,393,27.865384615384617,18.165134371798466,36.123327166663074,52.75,47.25
669,52,39,13,10,42,445,393,27.826923076923077,18.60022463585735,37.20993053324509,52.17307692307692,47.82692307692308
670,52,39,13,9,43,446,393,27.846153846153847,19.6836583167844,35.37132457581097,51.92307692307692,48.07692307692308
671,53,40,13,9,44,446,393,28.32075471698113,20.962866340113173,34.565435546679275,51.81132075471698,48.18867924528302
672,54,41,13,9,45,446,393,28.796296296296298,20.891062121766893,34.7015304708257,51.72222222222222,48.27777777777778
673,54,41,13,9,45,446,393,29.796296296296298,20.83073071131475,33.83593595535193,51.72222222222222,48.27777777777778
674,53,40,13,8,45,448,393,29.32075471698113,22.09269081416747,32.69976201602122,51.132075471698116,48.867924528301884
675,54,42,12,8,46,448,393,29.77777777777778,22.041959300706033,33.58767032892359,50.851851851851855,49.148148148148145
676,53,42,11,10,43,449,393,30.37735849056604,21.95238928975676,31.953271087601735,49.9811320754717,50.0188679245283
677,52,40,12,12,40,451,394,28.98076923076923,22.185221512229536,33.03884208036627,48.0,52.0
678,52,40,12,12,40,451,394,29.98076923076923,21.573945222574995,32.118362469732695,48.0,52.0
679,52,40,12,11,41,452,394,29.884615384615383,21.77942404429429,31.865984769836967,49.07692307692308,50.92307692307692
680,51,39,12,13,38,452,395,30.49019607843137,18.729793418173557,34.917265405355856,49.94117647058823,50.05882352941177
681,49,36,13,13,36,455,395,29.428571428571427,19.73350560316971,32.233018749023586,50.0,50.0
682,49,36,13,12,37,457,395,28.20408163265306,20.229250864604925,33.36258587008895,51.816326530612244,48.183673469387756
683,50,36,14,11,39,458,395,27.62,21.6575537454403,30.2424462545597,53.04,46.96
684,51,36,15,13,38,458,395,28.07843137254902,22.415259975052965,28.741602770045073,52.64705882352941,47.35294117647059
685,51,35,16,12,39,460,395,26.901960784313726,21.91762361424449,28.6510038367359,53.568627450980394,46.431372549019606
686,52,35,17,12,40,461,395,26.346153846153847,22.631118457484572,29.061189234823118,53.82692307692308,46.17307692307692
687,50,34,16,11,39,462,396,26.52,20.48526098537711,28.200626529744184,53.98,46.02
688,51,35,16,13,38,462,396,27.0,20.017376215398336,30.649290451268335,53.98039215686274,46.01960784313726
689,51,34,17,13,38,463,396,26.96078431372549,19.648132650503197,30.842063427928174,52.94117647058823,47.05882352941177
690,51,33,18,13,38,464,396,26.941176470588236,19.38887495589287,31.709164259793408,52.529411764705884,47.470588235294116
691,51,34,17,13,38,465,396,26.901960784313726,19.59206020857936,30.67707571561373,52.490196078431374,47.509803921568626
692,52,34,18,15,37,465,396,27.384615384615383,20.104751073796574,31.279864310818816,52.30769230769231,47.69230769230769
693,50,34,16,14,36,467,396,27.3,19.513826718474263,31.973784704490985,50.88,49.12
694,47,31,16,13,34,470,396,26.46808510638298,19.089703073368423,31.271999054291157,49.723404255319146,50.276595744680854
695,48,32,16,13,35,470,396,26.916666666666668,17.869027614085905,35.3809723859141,50.395833333333336,49.604166666666664
696,47,31,16,12,35,471,396,27.319148936170212,17.091687146421435,34.67154543244394,50.40425531914894,49.59574468085106
697,49,32,17,12,37,471,396,27.20408163265306,18.418154040490567,35.74511126563188,48.816326530612244,51.183673469387756
698,48,33,15,12,36,471,397,27.729166666666668,15.394842344718606,36.938490988614724,49.0,51.0
699,46,32,14,11,35,473,397,27.717391304347824,14.094857791249717,36.90792406249843,49.32608695652174,50.67391304347826
700,47,31,16,11,36,474,397,26.93617021276596,15.897010151086361,36.677457934020026,48.61702127659574,51.38297872340426
701,48,35,13,11,37,474,397,27.375,15.875718039226932,35.22844862743974,47.916666666666664,52.083333333333336
702,47,34,13,14,33,476,397,26.680851063829788,15.857249166500003,35.585148017116474,48.680851063829785,51.319148936170215
703,46,34,12,14,32,477,397,26.869565217391305,16.34707633390772,33.71814105739663,48.23913043478261,51.76086956521739
704,45,32,13,13,32,480,397,25.022222222222222,15.778110443104657,38.66633400133979,46.77777777777778,53.22222222222222
705,45,32,13,14,31,481,397,24.88888888888889,15.010145271442273,39.278743617446615,46.422222222222224,53.577777777777776
706,46,32,14,14,32,481,397,25.347826086956523,14.92690971679117,39.09482941364361,46.67391304347826,53.32608695652174
707,47,31,16,16,31,482,397,24.70212765957447,15.344201573791278,39.10260693684702,45.808510638297875,54.191489361702125
708,49,34,15,16,33,482,397,24.693877551020407,16.487757725026583,38.818364723953,45.734693877551024,54.265306122448976
709,51,33,18,15,36,483,397,23.725490196078432,18.052318197768443,37.79081905713352,45.705882352941174,54.294117647058826
710,52,33,19,15,37,483,397,24.26923076923077,17.00644050655215,36.839713339601694,45.88461538461539,54.11538461538461
711,55,33,22,17,38,483,397,23.945454545454545,18.503061493976464,37.00602941511444,46.61818181818182,53.38181818181818
712,55,33,22,18,37,484,397,23.963636363636365,18.705265857548632,35.24018868790592,46.872727272727275,53.127272727272725
713,57,33,24,16,41,486,397,22.17543859649123,20.833772229567533,34.9780204335395,48.14035087719298,51.85964912280702
714,60,33,27,16,44,486,397,22.066666666666666,22.93722373714855,33.06277626285144,47.93333333333333,52.06666666666667
715,60,32,28,18,42,487,397,22.15,24.543405181498354,28.918890097894923,47.666666666666664,52.333333333333336
716,62,33,29,18,44,487,397,22.43548387096774,25.807858122676866,30.03085155474249,49.096774193548384,50.903225806451616
717,62,33,29,17,45,487,398,22.661290322580644,25.499589398799344,29.746901818372915,49.516129032258064,50.483870967741936
718,66,34,32,17,49,487,398,22.28787878787879,27.66580629001883,29.92510280089026,48.60606060606061,51.39393939393939
719,64,31,33,17,47,490,399,20.703125,28.239111856843685,27.36947720947692,49.125,50.875
720,64,31,33,15,49,492,399,20.015625,28.43504379802365,28.3209133743172,50.515625,49.484375
721,64,29,35,14,50,492,401,19.875,26.840832221050377,30.718835160744778,51.71875,48.28125
722,62,29,33,13,49,492,403,20.274193548387096,25.079177555145623,31.03372579832949,50.67741935483871,49.32258064516129
723,62,29,33,12,50,494,403,19.629032258064516,27.393341667803625,29.574400267680243,50.725806451612904,49.274193548387096
724,62,29,33,11,51,495,403,19.70967741935484,29.125610517966958,27.713099159452398,51.274193548387096,48.725806451612904
725,62,30,32,13,49,495,406,18.838709677419356,26.246051791640458,32.75394820835954,50.935483870967744,49.064516129032256
726,61,30,31,13,48,496,406,19.311475409836067,26.439848626511946,30.24903369954847,51.18032786885246,48.81967213114754
727,62,31,31,12,50,496,407,19.548387096774192,27.836013563840858,29.728502565191402,52.435483870967744,47.564516129032256
728,62,33,29,12,50,496,407,20.548387096774192,28.643612782995707,27.3080001202301,52.435483870967744,47.564516129032256
729,61,34,27,13,48,496,409,20.868852459016395,27.385233056924204,29.844535049355642,54.0655737704918,45.9344262295082
730,61,37,24,13,48,496,410,21.229508196721312,27.446235515760204,30.176715303911934,52.704918032786885,47.295081967213115
731,65,38,27,13,52,496,410,20.923076923076923,30.377904123912682,29.560557414548857,53.276923076923076,46.723076923076924
732,64,39,25,13,51,497,411,21.21875,31.411362253672507,26.532635399473527,52.375,47.625
733,63,39,24,13,50,497,412,22.174603174603174,30.34224604875983,26.57838887187509,52.333333333333336,47.666666666666664
734,63,40,23,13,50,498,412,22.26984126984127,31.644951046809723,26.79949339763472,53.22222222222222,46.77777777777778
735,61,39,22,14,47,500,413,21.688524590163933,29.949088605207418,28.345993362005697,55.08196721311475,44.91803278688525
736,60,41,19,15,45,500,414,22.583333333333332,29.49121634757254,28.458783652427464,55.266666666666666,44.733333333333334
737,60,41,19,14,46,501,414,22.7,28.520516847231068,31.1461498194356,54.4,45.6
738,62,42,20,14,48,501,414,22.967741935483872,29.857241298496067,30.658887733761993,54.403225806451616,45.596774193548384
739,62,43,19,14,48,501,415,23.467741935483872,29.400183620885425,30.64907262268882,55.693548387096776,44.306451612903224
740,61,41,20,14,47,502,417,22.868852459016395,26.874464369154534,36.07637996979414,55.01639344262295,44.98360655737705
741,62,44,18,14,48,502,417,23.5,27.67846541580261,35.30540555193933,54.935483870967744,45.064516129032256
742,62,43,19,13,49,503,417,23.661290322580644,28.798299629337848,34.637184241629896,54.935483870967744,45.064516129032256
743,64,45,19,13,51,503,417,23.921875,27.98970904406571,35.900915955934295,55.171875,44.828125
744,64,44,20,14,50,504,417,23.96875,28.17586503026815,35.02725996973186,54.640625,45.359375
745,67,45,22,14,53,504,417,23.895522388059703,30.033177868822595,33.04144899684905,53.97014925373134,46.02985074626866
746,68,46,22,14,54,504,417,24.544117647058822,30.844464277424876,30.97906513433983,54.05882352941177,45.94117647058823
747,67,45,22,13,54,505,419,24.044776119402986,29.53897647321733,32.26699367603641,53.76119402985075,46.23880597014925
748,66,45,21,12,54,506,420,23.96969696969697,30.62520705619366,29.25358082259422,55.34848484848485,44.65151515151515
749,65,44,21,14,51,506,422,24.246153846153845,30.038780896314822,29.772691562774188,56.50769230769231,43.49230769230769
750,65,44,21,15,50,506,423,24.76923076923077,30.255926444721347,31.067150478355572,56.56923076923077,43.43076923076923
751,65,43,22,15,50,506,424,25.2,31.540296532709153,29.7058573134447,56.815384615384616,43.184615384615384
752,64,41,23,15,49,507,426,24.4375,30.134101349610443,32.076177733252244,57.71875,42.28125
753,62,40,22,16,46,508,427,24.774193548387096,29.242085611723166,30.515978904405866,57.983870967741936,42.016129032258064
754,60,38,22,17,43,508,430,24.633333333333333,24.079556255648235,36.72044374435177,56.75,43.25
755,60,38,22,19,41,509,430,24.766666666666666,25.940539738288862,34.49279359504447,57.0,43.0
756,62,40,22,19,43,509,430,24.967741935483872,27.07812169090931,33.212200889735854,56.12903225806452,43.87096774193548
757,64,42,22,21,43,509,430,25.1875,29.124320039894968,30.547554960105032,56.09375,43.90625
758,67,43,24,21,46,509,430,25.059701492537314,32.995973260972605,27.72044464947515,55.0,45.0
759,67,40,27,19,48,509,433,24.37313432835821,32.0967422199549,28.20543129251514,55.298507462686565,44.701492537313435
760,70,42,28,19,51,509,434,23.757142857142856,34.09908329534327,27.62503534147569,55.2,44.8
761,71,45,26,19,52,509,434,24.422535211267604,35.8533439404689,23.97764197502405,55.098591549295776,44.901408450704224
762,73,44,29,19,54,511,434,23.315068493150687,38.04884155191492,24.594994064523434,53.945205479452056,46.054794520547944
763,73,42,31,17,56,513,436,21.80821917808219,38.499385280901485,22.815683212249198,53.61643835616438,46.38356164383562
764,76,42,34,20,56,513,437,21.42105263157895,37.56343585749199,24.081300984613282,52.8421052631579,47.1578947368421
765,73,41,32,19,54,514,439,21.835616438356166,36.296687691415265,21.79033279131276,52.534246575342465,47.465753424657535
766,75,42,33,21,54,514,440,22.16,36.56754049852925,21.662934707067155,50.24,49.76
767,74,41,33,20,54,515,441,22.58108108108108,37.94926560912733,18.83451817465645,50.2027027027027,49.7972972972973
768,68,38,30,17,51,516,448,22.235294117647058,32.863830919872406,24.064476762388814,48.76470588235294,51.23529411764706
769,64,35,29,15,49,518,451,21.875,30.272161516999496,25.53536928417337,46.671875,53.328125
770,62,36,26,14,48,519,454,22.419354838709676,28.339411392814114,28.255085253477883,46.483870967741936,53.516129032258064
771,60,34,26,14,46,519,457,22.666666666666668,26.261353949095817,28.638646050904182,46.083333333333336,53.916666666666664
772,57,33,24,12,45,521,458,22.333333333333332,26.262175957256957,27.002753844659676,46.228070175438596,53.771929824561404
773,57,32,25,14,43,521,459,22.82456140350877,24.607284839042904,30.497974745388415,45.29824561403509,54.70175438596491
774,56,34,22,14,42,521,461,23.142857142857142,21.099196046054683,35.449564012174214,46.982142857142854,53.017857142857146
775,54,32,22,12,42,522,462,23.27777777777778,18.38967777752919,36.12884075237352,46.370370370370374,53.629629629629626
776,56,38,18,12,44,522,462,23.446428571428573,19.130233888698164,36.76262325415898,45.392857142857146,54.607142857142854
777,56,38,18,12,44,522,462,24.446428571428573,18.803481708632983,35.303661148509875,45.392857142857146,54.607142857142854
778,55,37,18,11,44,523,462,24.945454545454545,17.258843111515734,36.72919152590549,45.61818181818182,54.38181818181818
779,56,38,18,11,45,523,462,25.5,16.649220922472164,38.49363622038498,45.142857142857146,54.857142857142854
780,55,39,16,11,44,524,462,25.963636363636365,16.424217452361756,38.521237093092786,44.4,55.6
781,55,39,16,10,45,525,462,25.836363636363636,16.467059288538145,39.53451057911433,44.41818181818182,55.58181818181818
782,54,41,13,10,44,526,462,26.11111111111111,15.67992991137505,39.576269852362515,44.48148148148148,55.51851851851852
783,53,40,13,9,44,527,462,26.50943396226415,16.001364069209746,39.544135642796384,43.9622641509434,56.0377358490566
784,53,42,11,9,44,527,462,27.50943396226415,14.994302747363472,40.7415463092403,43.9622641509434,56.0377358490566
785,53,42,11,11,42,528,462,27.50943396226415,15.144731223042415,42.55338198450475,44.0,56.0
786,53,43,10,11,42,529,462,27.50943396226415,15.388854665909198,42.21491891899647,44.886792452830186,55.113207547169814
787,53,44,9,11,42,529,462,28.50943396226415,15.704528966708962,40.95584839178161,44.886792452830186,55.113207547169814
788,53,45,8,11,42,529,462,29.50943396226415,15.698045256347088,40.96233210214347,44.886792452830186,55.113207547169814
789,53,46,7,11,42,529,462,30.50943396226415,15.834015962973497,40.82636139551707,44.886792452830186,55.113207547169814
790,51,44,7,9,42,532,462,29.470588235294116,15.682263950741307,39.932983614106526,46.431372549019606,53.568627450980394
791,49,42,7,7,42,534,462,29.591836734693878,15.577118730623642,37.99430984080493,46.755102040816325,53.244897959183675
792,52,44,8,11,41,534,462,28.884615384615383,17.74699189697611,37.34916194917774,48.55769230769231,51.44230769230769
793,53,44,9,11,42,534,462,29.339622641509433,18.18019043569904,34.95188503599908,49.094339622641506,50.905660377358494
794,55,44,11,11,44,534,462,29.272727272727273,19.63991429434008,34.96008570565993,49.70909090909091,50.29090909090909
795,58,45,13,11,47,534,462,28.75862068965517,21.610186695282703,34.33808916678627,49.63793103448276,50.36206896551724
796,59,45,14,11,48,534,462,29.271186440677965,22.666483116646724,30.757245696912598,50.067796610169495,49.932203389830505
797,60,46,14,11,49,534,462,29.783333333333335,23.816139336713572,30.000527329953094,49.916666666666664,50.083333333333336
798,61,44,17,10,51,536,462,28.59016393442623,25.420638914025787,28.848117627133906,50.68852459016394,49.31147540983606
799,58,41,17,9,49,539,462,28.310344827586206,26.85131363812164,24.269376017050778,50.172413793103445,49.827586206896555
800,61,41,20,9,52,539,462,27.918032786885245,29.447904749461838,24.224226398079146,51.295081967213115,48.704918032786885
801,60,40,20,10,50,539,464,27.966666666666665,28.44123904705781,22.85876095294219,51.28333333333333,48.71666666666667
802,56,37,19,8,48,541,466,27.160714285714285,27.746694104229906,22.81504817482875,50.589285714285715,49.410714285714285
803,54,35,19,6,48,542,467,27.38888888888889,26.48761311774589,23.24405704141514,51.72222222222222,48.27777777777778
804,54,33,21,8,46,542,469,26.62962962962963,23.267415705283906,30.222889252827105,50.925925925925924,49.074074074074076
805,52,31,21,7,45,544,469,26.673076923076923,24.34442013764888,26.113041982569477,50.28846153846154,49.71153846153846
806,53,31,22,7,46,544,469,27.169811320754718,22.963329290789595,29.281953728078328,49.37735849056604,50.62264150943396
807,53,31,22,8,45,545,469,27.11320754716981,23.501407310850578,29.22236834971402,48.41509433962264,51.58490566037736
808,52,31,21,7,45,547,469,26.423076923076923,22.665074122230333,28.77723357007736,46.73076923076923,53.26923076923077
809,50,30,20,6,44,548,470,26.52,19.740667629047135,30.095404229110404,47.82,52.18
810,50,31,19,8,42,549,470,26.38,19.58163092550473,32.03313677915391,48.8,51.2
811,50,34,16,8,42,549,470,27.38,20.036689834884783,30.823310165115217,48.8,51.2
812,51,36,15,10,41,549,470,27.84313725490196,20.888033046068973,31.170790483342792,47.98039215686274,52.01960784313726
813,51,35,16,10,41,550,470,27.784313725490197,22.005894507136258,29.013713336000997,47.94117647058823,52.05882352941177
814,52,37,15,10,42,550,470,28.25,22.782204857319122,27.967795142680878,48.36538461538461,51.63461538461539
815,52,38,14,10,42,550,470,29.25,22.43391588833578,27.354545650125754,48.36538461538461,51.63461538461539
816,54,41,13,12,42,550,470,29.166666666666668,21.771849464968984,30.598520905401386,49.2962962962963,50.7037037037037
817,52,41,11,12,40,552,470,29.26923076923077,20.706567717581404,29.39417433047284,50.32692307692308,49.67307692307692
818,49,38,11,11,38,555,470,28.46938775510204,19.460520657310255,31.68233648554689,51.08163265306123,48.91836734693877
819,46,35,11,10,36,558,470,27.847826086956523,18.75437628147648,32.13692806634961,52.08695652173913,47.91304347826087
820,43,33,10,9,34,561,470,27.093023255813954,18.546845258492908,32.27742216059296,52.41860465116279,47.58139534883721
821,43,34,9,9,34,561,470,28.093023255813954,17.377135425718688,33.94844596963015,52.41860465116279,47.58139534883721
822,43,34,9,9,34,562,470,27.88372093023256,17.274558967604612,33.213813125418646,51.74418604651163,48.25581395348837
823,43,34,9,8,35,563,470,27.697674418604652,16.855773284531423,33.330273227096484,52.25581395348837,47.74418604651163
824,43,34,9,7,36,564,470,27.488372093023255,15.904716806368187,35.95574830991088,50.651162790697676,49.348837209302324
825,42,33,9,9,33,565,470,27.904761904761905,14.674929886321209,36.94411773272641,50.785714285714285,49.214285714285715
826,42,34,8,9,33,565,470,28.904761904761905,13.868293232504254,37.9888496246386,50.785714285714285,49.214285714285715
827,44,34,10,11,33,565,470,28.59090909090909,15.047680849879463,39.08868278648417,51.47727272727273,48.52272727272727
828,44,33,11,11,33,567,470,26.886363636363637,16.547827817021805,38.354196432813254,51.02272727272727,48.97727272727273
829,45,34,11,11,34,567,470,27.288888888888888,17.175676723642084,37.46876772080237,50.28888888888889,49.71111111111111
830,45,35,10,11,34,567,470,28.288888888888888,16.198771109961314,37.334562223372025,50.28888888888889,49.71111111111111
831,45,35,10,11,34,567,470,29.288888888888888,16.674659530648483,36.85867380268485,50.28888888888889,49.71111111111111
832,44,34,10,12,32,568,470,29.75,16.230185793677677,37.08993060826526,51.0,49.0
833,43,34,9,12,31,569,470,30.209302325581394,16.074135333575104,36.97237629433187,51.0,49.0
834,43,34,9,11,32,570,470,29.813953488372093,15.031872689456307,39.89835986868322,50.116279069767444,49.883720930232556
835,44,33,11,11,33,571,470,28.795454545454547,17.00512928049504,39.18058641530637,50.52272727272727,49.47727272727273
836,43,32,11,11,32,572,470,29.069767441860463,16.972794697672523,37.073716930234454,50.906976744186046,49.093023255813954
837,44,31,13,10,34,573,470,28.25,18.585219019457128,36.937508253270146,49.45454545454545,50.54545454545455
838,44,31,13,9,35,574,470,28.022727272727273,17.92792363476272,35.6402581834191,48.04545454545455,51.95454545454545
839,45,32,13,9,36,574,470,28.4,16.219192970696945,37.64747369596973,48.422222222222224,51.577777777777776
840,46,33,13,9,37,574,470,28.782608695652176,16.035221048276224,37.573474603897694,47.608695652173914,52.391304347826086
841,47,33,14,9,38,574,470,29.170212765957448,15.988499379319359,38.032777216425316,47.191489361702125,52.808510638297875
842,48,33,15,9,39,574,470,29.5625,16.84705711012208,36.132109556544584,46.583333333333336,53.416666666666664
843,47,33,14,8,39,576,470,29.0,15.811849255632488,37.818163931021054,45.5531914893617,54.4468085106383
844,48,34,14,10,38,576,470,29.395833333333332,16.13364201313976,37.67885798686024,46.645833333333336,53.354166666666664
845,49,36,13,10,39,576,470,29.79591836734694,16.548604478579172,36.83915062346164,46.93877551020408,53.06122448979592
846,48,35,13,9,39,577,470,30.3125,15.419376089671019,36.93479057699565,46.25,53.75
847,50,35,15,9,41,577,470,30.1,17.331995526434987,36.368004473565016,45.22,54.78
848,49,34,15,8,41,578,470,30.632653061224488,16.061902019093218,36.55034287886596,44.61224489795919,55.38775510204081
849,47,32,15,7,40,580,470,30.659574468085108,15.349176040122467,37.48061119392009,43.42553191489362,56.57446808510638
850,48,32,16,9,39,581,470,29.916666666666668,16.263910248462555,38.71525641820411,42.333333333333336,57.666666666666664
851,46,32,14,8,38,583,470,29.97826086956522,14.707527621884935,36.99493607022163,40.891304347826086,59.108695652173914
852,44,29,15,8,36,586,470,28.40909090909091,14.011308645410644,37.13838645583835,38.75,61.25
853,44,30,14,7,37,587,470,28.227272727272727,13.29054647878027,39.05036261212883,38.86363636363637,61.13636363636363
854,45,31,14,9,36,587,470,28.6,13.351963820994044,38.71470284567262,38.733333333333334,61.266666666666666
855,45,32,13,9,36,587,470,29.6,12.218033049672146,38.737522505883405,38.733333333333334,61.266666666666666
856,47,33,14,11,36,587,470,29.340425531914892,13.220469353786578,39.353998731319805,39.148936170212764,60.851063829787236
857,48,34,14,11,37,587,470,29.729166666666668,13.013941555538983,39.46522511112769,38.458333333333336,61.541666666666664
858,48,33,15,11,37,589,470,28.208333333333332,14.533064440843683,38.63360222582298,40.0,60.0
859,49,33,16,11,38,589,470,28.632653061224488,14.746872720713235,37.86537217724595,40.36734693877551,59.63265306122449
860,50,34,16,11,39,590,470,27.7,15.776943186945594,38.14305681305441,39.72,60.28
861,50,34,16,11,39,591,470,27.68,15.400531085679365,38.41946891432064,40.12,59.88
862,49,33,16,10,39,592,470,28.102040816326532,15.28996860761765,37.11819465768847,40.857142857142854,59.142857142857146
863,47,30,17,10,37,596,470,25.382978723404257,13.423444142857676,40.048961512252006,42.638297872340424,57.361702127659576
864,46,29,17,10,36,597,470,25.717391304347824,12.912979910197706,39.282672263715334,43.391304347826086,56.608695652173914
865,46,29,17,10,36,597,470,26.717391304347824,12.49112791541663,39.921915562844234,43.391304347826086,56.608695652173914
866,47,29,18,12,35,598,470,25.72340425531915,14.148591258898051,38.04289810280408,42.93617021276596,57.06382978723404
867,46,29,17,12,34,600,470,24.434782608695652,13.823407956620617,35.6548529129446,42.91304347826087,57.08695652173913
868,47,29,18,12,35,601,470,23.74468085106383,14.660532805470767,36.211807620061144,41.808510638297875,58.191489361702125
869,46,27,19,13,33,603,470,22.956521739130434,15.317982422632982,34.320870392287546,41.30434782608695,58.69565217391305
870,47,29,18,13,34,603,470,23.46808510638298,14.664989816630689,35.547776140816126,40.8936170212766,59.1063829787234
871,49,29,20,13,36,603,470,23.510204081632654,15.481121752153985,37.722959880499076,41.3469387755102,58.6530612244898
872,51,31,20,13,38,603,470,23.58823529411765,16.00516832884784,38.58306696526981,41.64705882352941,58.35294117647059
873,54,31,23,17,37,603,470,23.27777777777778,17.54184415421267,37.439637327268805,41.148148148148145,58.851851851851855
874,52,30,22,18,34,605,470,23.076923076923077,15.416118293222542,36.96849709139284,40.46153846153846,59.53846153846154
875,55,33,22,20,35,605,470,22.818181818181817,17.75278089703731,36.88358273932632,41.41818181818182,58.58181818181818
876,56,34,22,20,36,606,470,22.464285714285715,18.1787141701958,34.17842868694705,40.69642857142857,59.30357142857143
877,56,34,22,20,36,606,470,23.464285714285715,18.382319604839417,32.36768039516058,40.69642857142857,59.30357142857143
878,58,34,24,19,39,607,470,22.75862068965517,20.68745652634297,33.70909519779496,42.63793103448276,57.36206896551724
879,61,36,25,19,42,607,470,22.639344262295083,21.160111121677616,32.62677412422403,41.868852459016395,58.131147540983605
880,59,34,25,20,39,609,470,22.661016949152543,20.961551759102836,29.402798772647486,42.644067796610166,57.355932203389834
881,61,34,27,20,41,609,470,22.918032786885245,22.844234281566425,28.909864079089314,42.42622950819672,57.57377049180328
882,62,35,27,20,42,609,470,23.548387096774192,24.406747503985535,27.10938152827253,42.61290322580645,57.38709677419355
883,63,37,26,20,43,609,470,24.174603174603174,25.25546446872198,26.03024981699231,42.6031746031746,57.3968253968254
884,65,38,27,20,45,610,470,23.646153846153847,27.635094593233763,23.94952079138162,42.753846153846155,57.246153846153845
885,64,37,27,18,46,610,472,23.609375,26.948724786340108,23.801275213659892,42.875,57.125
886,63,34,29,17,46,611,474,22.444444444444443,25.92202594505147,26.141466118440594,43.857142857142854,56.142857142857146
887,61,32,29,14,47,613,476,20.688524590163933,24.472123423992127,27.888166259139577,43.68852459016394,56.31147540983606
888,60,31,29,11,49,614,478,19.45,22.263479941154074,30.054760295831763,44.35,55.65
889,61,33,28,13,48,614,478,20.131147540983605,22.564122247743683,28.796533489961238,44.14754098360656,55.85245901639344
890,63,34,29,13,50,614,478,20.49206349206349,22.5151657257055,28.834040623500847,43.87301587301587,56.12698412698413
891,64,36,28,13,51,615,479,19.6875,22.51768550198023,30.921531983447682,43.234375,56.765625
892,65,38,27,13,52,615,479,20.384615384615383,24.129451329800567,27.639779439430207,43.92307692307692,56.07692307692308
893,65,37,28,13,52,616,479,20.584615384615386,25.7492274041053,26.0507725958947,45.09230769230769,54.90769230769231
894,67,39,28,13,54,616,479,20.970149253731343,28.05128884148333,25.41139772568085,45.19402985074627,54.80597014925373
895,72,40,32,15,57,616,479,20.51388888888889,31.105826646684022,23.227506686649306,45.111111111111114,54.888888888888886
896,73,43,30,15,58,616,479,21.232876712328768,33.76238830110278,17.388296630404067,45.534246575342465,54.465753424657535
897,74,44,30,15,59,616,481,21.43243243243243,34.83433830974466,18.3278238524175,45.91891891891892,54.08108108108108
898,71,41,30,15,56,617,484,21.211267605633804,33.97281790270027,19.127243613633947,45.40845070422535,54.59154929577465
899,67,36,31,11,56,617,489,20.507462686567163,29.193205018951517,23.50819910876901,44.74626865671642,55.25373134328358
900,63,32,31,9,54,618,493,19.523809523809526,26.073791616549144,29.75160511342396,45.03174603174603,54.96825396825397
901,63,35,28,9,54,618,494,20.41269841269841,26.81863667464051,28.24231443673503,45.523809523809526,54.476190476190474
902,62,36,26,11,51,618,496,20.758064516129032,25.103771145103757,30.143581739146967,45.403225806451616,54.596774193548384
903,61,34,27,12,49,619,498,20.24590163934426,23.974427925113666,32.11749313576084,47.78688524590164,52.21311475409836
904,61,36,25,11,50,620,498,20.39344262295082,25.97665320530929,30.05613367993661,47.721311475409834,52.278688524590166
905,61,37,24,11,50,620,498,21.39344262295082,27.12310881693766,28.090005937160697,47.721311475409834,52.278688524590166
906,58,35,23,11,47,620,501,21.896551724137932,23.906802374084847,31.320119249193628,45.689655172413794,54.310344827586206
907,56,35,21,11,45,621,502,22.107142857142858,21.942248729272073,33.57702163915408,46.464285714285715,53.535714285714285
908,57,36,21,11,46,621,502,22.719298245614034,22.090715948307977,34.68121387625343,45.80701754385965,54.19298245614035
909,57,36,21,13,44,621,503,23.19298245614035,21.278251839676813,35.00244991470916,46.719298245614034,53.280701754385966
910,58,37,21,12,46,622,503,22.913793103448278,21.930821936529497,34.41054849186868,48.758620689655174,51.241379310344826
911,58,39,19,13,45,623,503,22.913793103448278,22.205069257294774,32.32941350132591,48.56896551724138,51.43103448275862
912,59,40,19,14,45,624,503,22.661016949152543,23.990464151291686,31.467162967352387,49.0,51.0
913,58,42,16,14,44,624,505,22.775862068965516,21.479340199175052,34.089625318066325,50.62068965517241,49.37931034482759
914,58,41,17,13,45,625,505,22.74137931034483,22.618330050657608,32.891450875209195,51.258620689655174,48.741379310344826
915,61,42,19,17,44,625,505,22.62295081967213,23.86185342003134,33.28568756357522,51.16393442622951,48.83606557377049
916,62,43,19,16,46,625,506,22.661290322580644,23.75400632086828,32.43382806182984,49.83870967741935,50.16129032258065
917,63,43,20,16,47,625,506,23.3015873015873,25.561867270487586,29.05718034856003,50.15873015873016,49.84126984126984
918,65,44,21,16,49,626,506,22.8,28.459305958682425,27.879155579779116,51.07692307692308,48.92307692307692
919,65,45,20,16,49,626,507,23.276923076923076,27.904779598576535,27.833681939885,51.53846153846154,48.46153846153846
920,68,46,22,16,52,626,507,23.25,29.292834111275127,28.839518829901344,52.61764705882353,47.38235294117647
921,69,44,25,15,54,626,509,22.942028985507246,28.623522676100944,30.608361381870075,53.08695652173913,46.91304347826087
922,70,43,27,17,53,626,510,23.071428571428573,29.102258343952695,28.954884513190166,52.51428571428571,47.48571428571429
923,70,43,27,17,53,626,510,24.071428571428573,30.08555307912984,26.543018349441596,52.51428571428571,47.48571428571429
924,68,41,27,16,52,627,512,23.852941176470587,30.58549105141952,26.25253386878799,53.3235294117647,46.6764705882353
925,65,38,27,14,51,629,514,23.26153846153846,30.62972286268975,26.736579552590335,52.89230769230769,47.10769230769231
926,64,36,28,13,51,630,516,22.546875,29.208872196851168,27.63691853150377,54.5,45.5
927,66,36,30,15,51,630,517,22.333333333333332,29.77484709097752,28.058486242355812,53.24242424242424,46.75757575757576
928,64,34,30,16,48,630,519,22.96875,28.79437884491786,27.658746155082138,53.546875,46.453125
929,61,34,27,15,46,631,521,22.60655737704918,27.58051474509658,28.206370500805058,53.80327868852459,46.19672131147541
930,61,34,27,14,47,632,522,22.114754098360656,27.479631114839172,28.110532819587057,54.42622950819672,45.57377049180328
931,59,33,26,14,45,632,525,21.88135593220339,23.014490118822554,31.570284398444574,54.28813559322034,45.71186440677966
932,60,35,25,14,46,632,525,22.516666666666666,25.20541763600425,30.427915697329084,54.65,45.35
933,59,35,24,13,46,634,525,22.135593220338983,29.054584286532425,26.413179496842407,54.813559322033896,45.186440677966104
934,58,36,22,13,45,635,525,22.603448275862068,29.625342241247356,25.109282740592327,55.706896551724135,44.293103448275865
935,59,38,21,13,46,635,526,22.983050847457626,28.18439972716119,29.459668069448977,55.79661016949152,44.20338983050848
936,60,40,20,13,47,635,527,23.05,29.204790925378468,28.345209074621533,55.28333333333333,44.71666666666667
937,60,41,19,13,47,636,527,23.2,29.698816669902662,26.95118333009734,55.016666666666666,44.983333333333334
938,58,39,19,12,46,637,529,22.362068965517242,28.278501473236958,28.738739906073388,53.5,46.5
939,57,39,18,12,45,637,530,23.473684210526315,26.86836342164899,29.745671666070308,53.473684210526315,46.526315789473685
940,56,40,16,14,42,637,531,24.607142857142858,26.751462982406743,28.927108446164684,53.785714285714285,46.214285714285715
941,55,39,16,14,41,637,533,25.436363636363637,23.892411006829636,32.20732317484305,53.21818181818182,46.78181818181818
942,55,38,17,13,42,638,534,25.09090909090909,23.154118965645292,35.29138383227291,52.836363636363636,47.163636363636364
943,55,38,17,13,42,638,535,25.78181818181818,22.775765781845188,33.96968876360936,52.61818181818182,47.38181818181818
944,55,39,16,13,42,638,535,26.78181818181818,22.83983336697785,32.99653026938579,52.61818181818182,47.38181818181818
945,54,38,16,14,40,639,535,27.333333333333332,22.88241896260295,32.284247704063716,53.48148148148148,46.51851851851852
946,54,41,13,16,38,639,535,28.333333333333332,23.761628153583782,31.405038513082882,53.48148148148148,46.51851851851852
947,54,41,13,16,38,639,536,29.0,22.26002419541491,35.1473832119925,52.666666666666664,47.333333333333336
948,53,40,13,16,37,640,536,29.566037735849058,21.704743955487807,35.106576799229174,53.24528301886792,46.75471698113208
949,55,42,13,16,39,640,536,29.490909090909092,22.80955198381684,35.64499347072862,52.763636363636365,47.236363636363635
950,55,41,14,16,39,641,536,29.490909090909092,24.073350692775275,34.417558398133814,53.945454545454545,46.054545454545455
951,57,42,15,15,42,642,536,28.45614035087719,25.146437886166364,32.60316715459634,53.21052631578947,46.78947368421053
952,56,43,13,14,42,643,536,28.982142857142858,24.386167588643808,31.523447359266978,52.535714285714285,47.464285714285715
953,56,42,14,13,43,645,536,28.017857142857142,24.69115859259201,31.35378453556351,52.55357142857143,47.44642857142857
954,58,42,16,13,45,645,537,27.74137931034483,24.734191370364815,32.769776051297505,52.741379310344826,47.258620689655174
955,55,39,16,12,43,648,537,27.363636363636363,22.890196550500885,32.19601484814796,51.85454545454545,48.14545454545455
956,57,39,18,12,45,648,537,27.403508771929825,24.55235657278139,31.903783778095807,52.14035087719298,47.85964912280702
957,59,40,19,12,47,648,537,27.47457627118644,25.90131550718781,31.115633645354563,52.898305084745765,47.101694915254235
958,59,41,18,11,48,649,537,27.491525423728813,26.781483733345247,29.352852959464467,52.932203389830505,47.067796610169495
959,61,41,20,11,50,649,538,26.934426229508198,27.187333245753898,29.665125770639545,51.57377049180328,48.42622950819672
960,62,39,23,11,51,650,539,25.951612903225808,26.619621796685536,29.821984071381813,50.935483870967744,49.064516129032256
961,61,37,24,9,52,652,539,25.57377049180328,27.120787600147118,27.141507481820096,51.68852459016394,48.31147540983606
962,64,37,27,11,53,652,539,25.375,30.54455282506017,24.97107217493983,51.484375,48.515625
963,64,37,27,10,54,652,540,25.703125,31.31841907791343,22.19720592208657,50.171875,49.828125
964,62,33,29,8,54,653,543,24.258064516129032,28.65707004428329,24.929886429544613,49.193548387096776,50.806451612903224
965,58,31,27,7,51,655,545,23.396551724137932,27.352163729549442,24.37065356300331,48.56896551724138,51.43103448275862
966,59,31,28,9,50,655,546,23.16949152542373,28.393478566921694,24.742114653417293,50.016949152542374,49.983050847457626
967,57,31,26,8,49,657,546,23.105263157894736,28.27194619805927,21.984749650263485,48.94736842105263,51.05263157894737
968,58,32,26,8,50,657,546,23.70689655172414,27.923386974501298,24.21454405998146,49.3448275862069,50.6551724137931
969,57,31,26,9,48,659,546,23.280701754385966,26.500932514845413,25.562711367556936,49.12280701754386,50.87719298245614
970,57,33,24,9,48,659,547,23.56140350877193,23.80795940263982,28.891230127244896,49.21052631578947,50.78947368421053
971,57,34,23,9,48,659,547,24.56140350877193,24.41763384613284,27.564822294218036,49.21052631578947,50.78947368421053
972,56,34,22,10,46,660,547,25.089285714285715,24.045806533665225,27.204193466334775,49.160714285714285,50.839285714285715
973,56,34,22,10,46,661,547,25.035714285714285,26.11549412389441,26.027363018962735,48.732142857142854,51.267857142857146
974,57,36,21,10,47,661,548,25.140350877192983,27.095757619907314,27.027049397636546,49.56140350877193,50.43859649122807
975,57,38,19,10,47,662,548,25.17543859649123,27.72755039548223,25.857769734915603,49.59649122807018,50.40350877192982
976,55,38,17,10,45,662,550,25.581818181818182,26.35766899022386,26.831104234350253,49.78181818181818,50.21818181818182
977,53,37,16,9,44,663,551,25.60377358490566,24.999177084250547,28.711484906310094,49.39622641509434,50.60377358490566
978,53,39,14,8,45,663,552,25.830188679245282,23.28789674468958,30.003005118525166,50.094339622641506,49.905660377358494
979,51,39,12,6,45,665,552,25.431372549019606,23.82966031461914,29.02665265906905,49.23529411764706,50.76470588235294
980,52,41,11,6,46,665,552,25.942307692307693,24.95640550697785,28.35128680071446,50.0,50.0
981,51,39,12,6,45,667,552,25.41176470588235,24.881397315385414,29.628406606183212,49.72549019607843,50.27450980392157
982,51,41,10,6,45,667,552,26.41176470588235,25.68763714926397,28.233931478187014,49.72549019607843,50.27450980392157
983,53,41,12,6,47,667,552,26.41509433962264,28.2822479947091,26.00077087321543,48.698113207547166,51.301886792452834
984,52,40,12,8,44,667,554,26.942307692307693,25.307750821643772,28.594659961576433,48.65384615384615,51.34615384615385
985,53,40,13,8,45,668,554,26.169811320754718,25.07514028253925,30.811652170290934,49.094339622641506,50.905660377358494
986,50,38,12,8,42,670,555,26.22,24.458599103963046,28.691775214496953,48.36,51.64
987,50,38,12,8,42,670,555,27.22,25.04844021295288,28.41155978704712,48.36,51.64
988,52,37,15,8,44,671,555,25.884615384615383,25.56651806382176,32.26040501310131,46.75,53.25
989,53,38,15,8,45,671,555,26.39622641509434,26.56017788145461,29.911520231752938,47.075471698113205,52.924528301886795
990,53,38,15,10,43,671,556,26.660377358490567,26.937393548417525,28.8418287539951,46.0,54.0
991,52,37,15,10,42,673,557,25.03846153846154,26.78626651959376,30.960726342096322,45.11538461538461,54.88461538461539
992,54,37,17,10,44,673,557,25.11111111111111,27.27474085027108,31.058592483062256,44.53703703703704,55.46296296296296
993,57,37,20,10,47,673,557,24.789473684210527,28.26346388109904,30.052325592585177,44.3859649122807,55.6140350877193
994,58,37,21,10,48,674,557,24.448275862068964,28.271585524634435,30.228414475365565,44.206896551724135,55.793103448275865
995,59,37,22,10,49,674,557,25.033898305084747,29.652298166540128,28.1443120029514,45.016949152542374,54.983050847457626
996,59,38,21,10,49,674,558,25.76271186440678,29.12197436314098,27.55599173855394,45.25423728813559,54.74576271186441
997,57,35,22,9,48,674,561,25.42105263157895,26.46568215505403,29.996891218737968,45.59649122807018,54.40350877192982
998,57,34,23,10,47,675,561,25.50877192982456,27.907753302680117,27.302773013109356,45.73684210526316,54.26315789473684
999,57,36,21,10,47,675,561,26.50877192982456,27.385078602312902,27.123693327511663,45.73684210526316,54.26315789473684
