year,Population,Adults,Children,Singles,Taken,Hunger Deaths,Old Age Deaths,Average Age,Average Hunger,Average Prowess,Average Selfishness,Average Reciprocity
0,21,20,1,6,15,0,0,19.095238095238095,11.904761904761905,48.142857142857146,61.523809523809526,38.476190476190474
1,22,20,2,6,16,0,0,19.227272727272727,11.818181818181818,46.31818181818182,62.95454545454545,37.04545454545455
2,23,20,3,6,17,0,0,19.391304347826086,11.73913043478261,47.391304347826086,63.34782608695652,36.65217391304348
3,25,20,5,8,17,0,0,18.84,13.2,47.2,63.96,36.04
4,27,20,7,8,19,0,0,18.444444444444443,12.962962962962964,48.2962962962963,64.51851851851852,35.48148148148148
5,28,20,8,8,20,0,0,18.785714285714285,11.428571428571429,46.714285714285715,64.5,35.5
6,29,20,9,8,21,0,0,19.137931034482758,11.379310344827585,45.86206896551724,63.13793103448276,36.86206896551724
7,32,20,12,8,24,0,0,18.34375,13.75,49.1875,63.1875,36.8125
8,32,20,12,10,22,0,0,19.34375,10.060304048292089,48.18969595170791,63.1875,36.8125
9,32,20,12,10,22,0,0,20.34375,10.0,48.25,63.1875,36.8125
10,33,20,13,10,23,0,0,20.727272727272727,11.212121212121213,49.121212121212125,62.63636363636363,37.36363636363637
11,33,20,13,10,23,0,0,21.727272727272727,10.0,48.81818181818182,62.63636363636363,37.36363636363637
12,33,20,13,10,23,0,0,22.727272727272727,10.0,48.81818181818182,62.63636363636363,37.36363636363637
13,34,20,14,10,24,0,0,23.058823529411764,11.2900423015301,49.504075345528726,61.205882352941174,38.794117647058826
14,35,20,15,10,25,0,0,23.4,11.142857142857142,49.34285714285714,61.285714285714285,38.714285714285715
15,36,20,16,12,24,0,0,23.75,11.57038222377074,47.707395554007036,62.27777777777778,37.72222222222222
16,38,21,17,12,26,0,0,23.5,12.914100662418152,48.164846706002905,60.23684210526316,39.76315789473684
17,41,22,19,12,29,0,0,22.78048780487805,14.621449789762599,47.524891673652036,58.65853658536585,41.34146341463415
18,43,23,20,14,29,0,0,22.72093023255814,15.033349661419503,43.94339452462701,56.83720930232558,43.16279069767442
19,45,25,20,16,29,0,0,22.711111111111112,15.2745849891869,44.05874834414643,55.733333333333334,44.266666666666666
20,47,27,20,16,31,0,0,22.74468085106383,16.82853034238299,42.02253348740424,55.51063829787234,44.48936170212766
21,47,28,19,16,31,0,0,23.74468085106383,16.290096496121294,40.43330775919785,55.51063829787234,44.48936170212766
22,50,29,21,20,30,0,0,23.32,19.250323148594465,41.60967685140554,53.2,46.8
23,54,32,22,20,34,0,0,22.59259259259259,21.500334101236337,38.92559182468959,53.666666666666664,46.333333333333336
24,56,32,24,20,36,0,0,22.785714285714285,22.09160773710283,36.55124940575432,53.464285714285715,46.535714285714285
25,57,31,26,21,36,0,1,22.596491228070175,20.546794610870556,38.40057381018207,52.91228070175438,47.08771929824562
26,58,32,26,21,37,0,1,23.20689655172414,21.520767429983824,36.85854291484376,52.53448275862069,47.46551724137931
27,58,31,27,20,38,0,2,23.413793103448278,21.25886780017135,36.58595978603555,52.741379310344826,47.258620689655174
28,60,31,29,20,40,0,2,23.633333333333333,22.677665613671113,36.58900105299555,53.45,46.55
29,62,32,30,20,42,0,2,23.870967741935484,23.705336738843798,35.181760035349754,53.016129032258064,46.983870967741936
30,62,31,31,18,44,0,4,23.258064516129032,23.05108273989219,35.73047239246822,53.354838709677416,46.645161290322584
31,62,30,32,16,46,1,5,22.612903225806452,23.339282237378697,34.386511816252565,53.75806451612903,46.24193548387097
32,58,28,30,14,44,4,6,21.982758620689655,20.809606688621184,36.931570366053315,53.94827586206897,46.05172413793103
33,57,28,29,15,42,5,7,21.50877192982456,20.470957444217344,38.65184957332652,54.21052631578947,45.78947368421053
34,58,31,27,15,43,5,7,22.137931034482758,20.19702239375987,39.68228795106772,53.63793103448276,46.36206896551724
35,56,30,26,13,43,8,7,20.982142857142858,20.778999135567698,37.738458988471834,52.30357142857143,47.69642857142857
36,54,29,25,12,42,9,8,21.12962962962963,16.328777637034918,40.9425771680825,51.96296296296296,48.03703703703704
37,53,29,24,12,41,10,8,21.452830188679247,16.478987697383634,40.434346072101654,52.679245283018865,47.320754716981135
38,54,31,23,14,40,10,8,22.055555555555557,16.421971884408784,41.429879967443064,51.74074074074074,48.25925925925926
39,56,34,22,14,42,10,8,22.267857142857142,16.878240323959247,42.30033110461219,52.160714285714285,47.839285714285715
40,57,38,19,14,43,10,8,22.87719298245614,16.816338425241394,40.69243350458316,52.228070175438596,47.771929824561404
41,58,39,19,18,40,11,8,22.43103448275862,17.394713697661086,40.794941474752704,51.810344827586206,48.189655172413794
42,60,39,21,17,43,12,8,21.666666666666668,18.844235919412846,39.41636042927989,50.38333333333333,49.61666666666667
43,61,40,21,17,44,12,8,22.311475409836067,19.58117102454941,37.681124057417804,51.01639344262295,48.98360655737705
44,63,41,22,18,45,12,9,21.904761904761905,19.706178165019285,39.958527800737215,49.26984126984127,50.73015873015873
45,65,40,25,18,47,13,9,21.23076923076923,21.302447046762826,37.88026796620116,50.95384615384615,49.04615384615385
46,67,44,23,22,45,13,9,21.597014925373134,23.227413642544203,34.74273561118714,50.850746268656714,49.149253731343286
47,71,46,25,22,49,13,9,21.380281690140844,25.89525190410645,32.34418471561186,51.056338028169016,48.943661971830984
48,73,46,27,22,51,13,9,21.794520547945204,27.275967714757336,28.696635024968693,50.95890410958904,49.04109589041096
49,74,44,30,22,52,13,11,21.256756756756758,27.316229065328336,29.53512228602302,50.148648648648646,49.851351351351354
50,75,44,31,21,54,13,13,21.013333333333332,27.410878132691977,27.587651209107893,49.906666666666666,50.093333333333334
51,78,44,34,20,58,14,13,20.294871794871796,28.54196152598811,27.24018340028264,50.32051282051282,49.67948717948718
52,74,40,34,19,55,15,16,20.04054054054054,26.460352124138026,26.916205981688485,49.027027027027025,50.972972972972975
53,74,38,36,17,57,15,18,20.04054054054054,26.208666894430138,29.263382091792092,49.63513513513514,50.36486486486486
54,72,37,35,15,57,17,18,20.180555555555557,26.657315481351215,27.078795629759895,48.55555555555556,51.44444444444444
55,72,37,35,15,57,17,19,20.65277777777778,27.617936221852613,27.127177590085054,48.56944444444444,51.43055555555556
56,73,38,35,15,58,17,20,20.80821917808219,28.14755806330157,27.60586659423268,49.9041095890411,50.0958904109589
57,71,36,35,13,58,17,24,19.985915492957748,25.80661553078778,28.28880311469738,51.056338028169016,48.943661971830984
58,71,37,34,12,59,18,24,20.253521126760564,27.7729735913156,25.846744718543558,50.478873239436616,49.521126760563384
59,70,37,33,15,55,18,25,20.985714285714284,27.57513954956059,25.186138285639668,50.885714285714286,49.114285714285714
60,71,39,32,18,53,18,27,20.52112676056338,27.667507339717332,26.86770398066866,49.71830985915493,50.28169014084507
61,71,41,30,20,51,18,27,21.52112676056338,29.213508955008187,23.349871326681956,49.71830985915493,50.28169014084507
62,74,44,30,20,54,18,27,21.64864864864865,31.236199613431886,23.371908494676227,49.62162162162162,50.37837837837838
63,76,46,30,20,56,18,28,21.63157894736842,30.51457369256458,25.248584202172264,48.14473684210526,51.85526315789474
64,75,46,29,18,57,18,31,21.173333333333332,29.88919782495337,24.57078808559449,46.88,53.12
65,76,46,30,18,58,18,31,21.894736842105264,31.945035220792665,22.633912147628397,46.48684210526316,53.51315789473684
66,75,49,26,17,58,18,33,22.093333333333334,30.773169021031876,22.630492330256715,46.373333333333335,53.626666666666665
67,76,51,25,16,60,18,35,22.026315789473685,30.303132957566348,24.704167734977275,47.3421052631579,52.6578947368421
68,76,49,27,17,59,19,37,21.30263157894737,29.048010134371424,27.951989865628583,47.973684210526315,52.026315789473685
69,75,48,27,17,58,19,40,21.506666666666668,27.25386089076399,29.559472442569344,47.08,52.92
70,74,46,28,15,59,19,42,21.783783783783782,26.795081874109865,29.089580259296294,47.2027027027027,52.7972972972973
71,74,46,28,15,59,19,43,22.243243243243242,27.676580373315474,29.05314935641426,47.12162162162162,52.87837837837838
72,73,47,26,17,56,19,44,23.315068493150687,26.944497961393036,29.00070751805902,46.49315068493151,53.50684931506849
73,72,46,26,17,55,21,45,22.5,26.969752727296974,29.937659486813338,46.69444444444444,53.30555555555556
74,74,46,28,17,57,21,45,22.89189189189189,27.880796708358638,28.28136545380353,46.351351351351354,53.648648648648646
75,75,47,28,17,58,21,46,23.386666666666667,28.04872634335955,28.15399121078007,45.86666666666667,54.13333333333333
76,74,48,26,17,57,22,47,23.783783783783782,27.266961938891004,27.827632655703592,45.78378378378378,54.21621621621622
77,76,48,28,17,59,22,47,24.157894736842106,27.790422135122544,28.617472601719562,45.578947368421055,54.421052631578945
78,75,47,28,18,57,23,47,24.76,27.495034801793683,27.528991123992384,45.96,54.04
79,78,51,27,18,60,23,47,24.807692307692307,29.79163690037228,26.79810668937131,45.666666666666664,54.333333333333336
80,75,52,23,18,57,24,49,25.68,28.81411115204913,25.17719384565555,45.96,54.04
81,74,49,25,17,57,26,50,25.364864864864863,30.086805564570103,26.156437678673143,45.148648648648646,54.851351351351354
82,73,46,27,16,57,27,52,25.0,29.712713680416435,25.779974222087258,44.61643835616438,55.38356164383562
83,72,47,25,15,57,28,53,25.305555555555557,28.60225241763524,25.801456850713045,43.80555555555556,56.19444444444444
84,73,50,23,16,57,28,55,25.19178082191781,27.745938406837176,29.034936377187037,42.726027397260275,57.273972602739725
85,71,46,25,14,57,30,57,24.507042253521128,26.955844809395913,28.879879372984735,44.436619718309856,55.563380281690144
86,71,45,26,13,58,30,59,24.281690140845072,25.348473252848283,30.802840084023455,45.521126760563384,54.478873239436616
87,71,46,25,13,58,30,60,24.676056338028168,25.653992695946922,29.280366816484914,46.605633802816904,53.394366197183096
88,70,45,25,12,58,30,62,25.114285714285714,25.259111236830268,29.449420976428403,46.6,53.4
89,71,45,26,12,59,30,62,25.760563380281692,26.899098199645437,27.96005672993203,47.19718309859155,52.80281690140845
90,71,47,24,12,59,30,63,26.56338028169014,26.850910115115237,27.52937157502561,46.521126760563384,53.478873239436616
91,70,47,23,14,56,31,64,26.442857142857143,27.214163723199192,26.60012199108652,46.77142857142857,53.22857142857143
92,72,49,23,14,58,31,64,26.708333333333332,27.744598148663858,27.283179629113917,45.708333333333336,54.291666666666664
93,73,48,25,13,60,33,64,25.835616438356166,29.20319101432857,25.591329533616634,46.97260273972603,53.02739726027397
94,75,48,27,15,60,33,64,26.14666666666667,29.943956162128895,23.296043837871107,46.906666666666666,53.093333333333334
95,74,48,26,15,59,34,67,26.10810810810811,28.66391848519369,25.200946379671173,47.25675675675676,52.74324324324324
96,74,47,27,15,59,35,68,26.18918918918919,29.144343760801632,23.977277860819992,47.21621621621622,52.78378378378378
97,76,47,29,15,61,35,69,26.276315789473685,29.92579749719923,22.666307765958656,48.26315789473684,51.73684210526316
98,74,45,29,15,59,36,71,26.445945945945947,28.486349006955255,23.488344441636663,48.986486486486484,51.013513513513516
99,75,46,29,15,60,36,71,27.093333333333334,30.12427144422368,21.862395222442984,49.093333333333334,50.906666666666666
100,74,44,30,16,58,37,73,27.243243243243242,28.210327611054584,23.49607085282814,51.0,49.0
101,72,45,27,14,58,38,76,26.97222222222222,26.25960529440353,23.868321886136748,50.861111111111114,49.138888888888886
102,70,43,27,14,56,39,78,26.4,26.179892674597177,24.161954761764655,49.75714285714286,50.24285714285714
103,71,42,29,13,58,39,79,26.281690140845072,26.346815323745677,26.28843099662535,50.15492957746479,49.84507042253521
104,72,42,30,13,59,40,79,26.125,28.7333763703281,22.15551251856079,50.791666666666664,49.208333333333336
105,71,41,30,13,58,42,80,25.704225352112676,29.330496657489267,22.06504502742364,50.816901408450704,49.183098591549296
106,68,38,30,13,55,43,83,26.25,26.760822841783707,25.327412452333945,51.55882352941177,48.44117647058823
107,65,36,29,12,53,45,84,26.323076923076922,24.04000039905085,27.98239652327013,50.12307692307692,49.87692307692308
108,64,34,30,11,53,47,84,25.953125,24.208489732792998,28.932135267207002,50.78125,49.21875
109,62,36,26,10,52,49,85,25.677419354838708,21.697616170641293,32.07011197249488,49.70967741935484,50.29032258064516
110,59,33,26,7,52,53,85,24.372881355932204,22.796157141551785,30.43381233875596,48.847457627118644,51.152542372881356
111,59,35,24,9,50,53,86,25.050847457627118,21.781930241376166,30.828239250149256,50.33898305084746,49.66101694915254
112,59,35,24,9,50,54,87,24.322033898305083,20.156999984715462,32.9079230021539,51.152542372881356,48.847457627118644
113,58,34,24,9,49,56,87,23.982758620689655,19.893659079059745,32.261513334733365,52.43103448275862,47.56896551724138
114,58,36,22,9,49,57,87,23.93103448275862,19.668497477592716,31.93144239435036,51.189655172413794,48.810344827586206
115,56,35,21,7,49,59,87,23.928571428571427,18.95612317771269,30.990305393715882,52.125,47.875
116,58,38,20,7,51,59,87,24.103448275862068,20.4378279248559,31.648378971695823,52.56896551724138,47.43103448275862
117,59,40,19,9,50,59,87,24.694915254237287,21.13163583328596,29.61412687857845,53.23728813559322,46.76271186440678
118,61,41,20,11,50,59,87,24.885245901639344,22.19606838404541,28.361308665134917,53.01639344262295,46.98360655737705
119,63,42,21,15,48,59,87,25.095238095238095,23.364348581418117,27.2546990376295,52.80952380952381,47.19047619047619
120,64,45,19,15,49,59,87,25.703125,23.98511846168463,25.13988153831537,52.609375,47.390625
121,63,45,18,15,48,61,87,25.38095238095238,25.360046706310257,24.306619960356407,53.92063492063492,46.07936507936508
122,65,45,20,14,51,62,87,24.753846153846155,28.303359599832422,23.696640400167578,53.76923076923077,46.23076923076923
123,64,41,23,13,51,64,89,23.53125,27.15906208870723,23.043091823031233,55.1875,44.8125
124,62,38,24,13,49,66,90,23.080645161290324,27.910625203230826,22.815181248382075,54.66129032258065,45.33870967741935
125,63,39,24,15,48,66,90,23.714285714285715,28.98862652628556,21.693913156254123,54.61904761904762,45.38095238095238
126,63,39,24,15,48,66,92,23.761904761904763,27.309922716700974,23.664877432141136,53.73015873015873,46.26984126984127
127,60,36,24,15,45,68,94,23.166666666666668,24.353727058790824,28.27960627454251,54.4,45.6
128,55,32,23,14,41,70,97,22.636363636363637,19.147837899923058,31.27358664197699,55.18181818181818,44.81818181818182
129,56,33,23,14,42,71,97,22.267857142857142,20.926120344062674,33.491408746585975,54.910714285714285,45.089285714285715
130,57,33,24,14,43,71,97,22.87719298245614,21.252212813532378,32.62498016892376,55.280701754385966,44.719298245614034
131,59,34,25,14,45,71,97,23.10169491525424,21.94002941322606,33.314207874909535,53.983050847457626,46.016949152542374
132,60,34,26,13,47,72,97,22.85,23.798962216807784,31.350684320563655,55.11666666666667,44.88333333333333
133,61,34,27,13,48,72,98,22.901639344262296,23.149701742715113,32.53882284744882,54.278688524590166,45.721311475409834
134,60,34,26,13,47,74,98,22.283333333333335,24.147422794512856,29.743646278170736,53.95,46.05
135,62,37,25,15,47,74,98,22.56451612903226,25.364712960823777,30.52238381336977,54.354838709677416,45.645161290322584
136,62,36,26,14,48,75,98,22.516129032258064,27.073669161150878,28.957961153963346,54.12903225806452,45.87096774193548
137,60,36,24,15,45,77,98,22.433333333333334,29.72394139370459,24.585479719758716,53.6,46.4
138,61,38,23,14,47,78,98,22.21311475409836,29.216807591456234,25.094667818379833,53.39344262295082,46.60655737704918
139,60,39,21,14,46,78,99,23.0,28.405848977888255,25.127484355445073,53.583333333333336,46.416666666666664
140,61,39,22,16,45,78,100,23.0327868852459,27.499136675175333,28.238568242857458,52.114754098360656,47.885245901639344
141,63,41,22,16,47,78,100,23.3015873015873,27.774036506543467,27.210090477583517,52.0,48.0
142,66,41,25,18,48,78,100,23.242424242424242,29.461914058444755,26.28051018397949,52.04545454545455,47.95454545454545
143,65,42,23,17,48,79,100,23.815384615384616,28.710897208303273,24.67371817631211,52.6,47.4
144,65,43,22,19,46,79,100,24.815384615384616,29.43385639299851,23.950758991616876,52.6,47.4
145,66,45,21,21,45,79,100,25.439393939393938,30.366870209280346,24.102826760416622,52.90909090909091,47.09090909090909
146,67,46,21,21,46,79,100,26.059701492537314,28.47864494907458,26.163146095701542,52.223880597014926,47.776119402985074
147,64,47,17,20,44,80,102,27.140625,25.972635105407758,27.585136910854885,51.875,48.125
148,63,47,16,19,44,82,102,26.73015873015873,25.359736687954864,29.560898232680053,52.682539682539684,47.317460317460316
149,63,47,16,18,45,83,102,26.841269841269842,25.47651036611953,29.967934078324916,51.698412698412696,48.301587301587304
150,62,48,14,18,44,83,103,27.661290322580644,23.929675275918974,31.050142672323787,51.096774193548384,48.903225806451616
151,60,47,13,17,43,85,103,27.883333333333333,23.398358318915243,32.58497501441809,50.6,49.4
152,62,48,14,17,45,85,103,27.983870967741936,23.0262369754998,34.68344044385504,50.32258064516129,49.67741935483871
153,61,47,14,17,44,86,103,28.475409836065573,23.299829416120545,33.04081536158799,50.16393442622951,49.83606557377049
154,61,48,13,17,44,87,103,28.57377049180328,23.281413730137963,33.8989141387145,50.0655737704918,49.9344262295082
155,61,47,14,16,45,88,103,28.672131147540984,23.520573143205354,33.6051762374687,50.68852459016394,49.31147540983606
156,63,49,14,16,47,88,103,28.761904761904763,23.780395157241923,33.473573096726334,49.65079365079365,50.34920634920635
157,63,48,15,17,46,90,103,28.11111111111111,24.338365039763808,32.979095277696516,48.888888888888886,51.111111111111114
158,62,50,12,19,43,90,104,29.0,23.509243717466163,32.29720789543706,48.145161290322584,51.854838709677416
159,64,50,14,19,45,90,104,29.09375,25.287351109691265,32.853273890308735,48.515625,51.484375
160,64,48,16,17,47,91,105,28.59375,26.393761032501036,30.53570815062544,47.046875,52.953125
161,62,45,17,15,47,94,106,27.20967741935484,27.69529078981229,26.724064048897386,45.41935483870968,54.58064516129032
162,62,44,18,15,47,96,106,26.548387096774192,29.21631916198435,24.283285917044978,46.16129032258065,53.83870967741935
163,60,42,18,13,47,96,108,27.066666666666666,26.319853787355722,24.896812879310946,45.96666666666667,54.03333333333333
164,61,41,20,13,48,96,109,26.852459016393443,24.688514523139638,28.43546010874052,45.0,55.0
165,59,40,19,13,46,97,110,27.135593220338983,22.14461834980111,30.208694384197898,45.30508474576271,54.69491525423729
166,58,39,19,14,44,98,111,26.724137931034484,18.83266591437157,32.16229623010689,46.224137931034484,53.775862068965516
167,60,39,21,16,44,98,111,26.833333333333332,19.420313120031047,33.56302021330229,45.7,54.3
168,59,40,19,16,43,99,111,27.305084745762713,18.414789935487043,33.66995582722482,45.11864406779661,54.88135593220339
169,59,39,20,15,44,100,111,27.338983050847457,17.595449654639637,35.74353339620782,44.3728813559322,55.6271186440678
170,61,40,21,15,46,100,111,27.442622950819672,18.146468961545388,36.509268743372644,44.16393442622951,55.83606557377049
171,60,40,20,15,45,101,111,28.033333333333335,17.960398122186632,35.439601877813374,44.6,55.4
172,57,36,21,12,45,105,111,26.771929824561404,16.668687347572593,39.00892263313992,44.10526315789474,55.89473684210526
173,58,40,18,12,46,105,111,27.310344827586206,16.859498229476408,38.19222590845462,44.93103448275862,55.06896551724138
174,57,39,18,13,44,106,111,27.82456140350877,15.68993390071835,38.538136274720245,44.228070175438596,55.771929824561404
175,58,40,18,13,45,106,111,28.344827586206897,17.448499620804967,38.08598313781573,44.275862068965516,55.724137931034484
176,59,41,18,15,44,107,111,27.983050847457626,18.746585887071785,37.59239716377567,45.6271186440678,54.3728813559322
177,60,40,20,14,46,109,111,26.683333333333334,20.203793419710756,35.98404361155439,44.766666666666666,55.233333333333334
178,59,42,17,13,46,110,111,27.271186440677965,19.830649197908325,33.38337963763293,44.25423728813559,55.74576271186441
179,60,42,18,13,47,110,111,27.816666666666666,21.117017723308702,33.74964894335797,43.68333333333333,56.31666666666667
180,61,45,16,13,48,110,111,28.360655737704917,20.144714484445903,34.65856420407869,44.22950819672131,55.77049180327869
181,61,44,17,13,48,111,111,28.524590163934427,20.223976624442066,33.333400424738265,44.59016393442623,55.40983606557377
182,64,44,20,13,51,112,111,27.328125,22.0744863949505,34.0348886050495,44.859375,55.140625
183,64,45,19,12,52,112,112,27.53125,20.626894524268668,32.62310547573133,45.453125,54.546875
184,65,45,20,12,53,112,112,28.107692307692307,23.08436022635972,30.992562850563356,44.83076923076923,55.16923076923077
185,63,44,19,13,50,114,112,28.26984126984127,22.629906723532027,29.522238776448535,45.76190476190476,54.23809523809524
186,60,42,18,13,47,118,112,26.783333333333335,22.68175988387598,29.131103269172733,45.4,54.6
187,60,40,20,13,47,120,112,25.933333333333334,23.52100700378212,27.53845262206327,44.18333333333333,55.81666666666667
188,60,39,21,13,47,121,112,26.083333333333332,25.57246114961118,25.59420551705548,43.2,56.8
189,61,39,22,12,49,121,113,25.852459016393443,26.441001738890463,24.739326129961995,43.57377049180328,56.42622950819672
190,59,36,23,13,46,123,115,24.033898305084747,23.469963458124894,27.402021228922603,43.28813559322034,56.71186440677966
191,61,36,25,15,46,123,116,23.262295081967213,23.40832383772174,28.39193562187097,41.83606557377049,58.16393442622951
192,59,35,24,14,45,123,119,22.796610169491526,20.135598813156584,29.291112252754633,42.49152542372882,57.50847457627118
193,60,35,25,15,45,124,120,21.95,20.692897427965654,30.040435905367683,43.8,56.2
194,64,36,28,15,49,124,120,21.578125,24.11472705811145,26.69777294188855,44.90625,55.09375
195,64,36,28,14,50,125,120,21.765625,25.139945097743407,24.20008632147248,43.78125,56.21875
196,65,36,29,15,50,125,121,21.70769230769231,26.44142639328385,24.020112068254612,42.66153846153846,57.33846153846154
197,65,36,29,14,51,125,122,21.846153846153847,26.031041230106922,23.468923883134853,43.10769230769231,56.89230769230769
198,65,39,26,14,51,125,122,22.846153846153847,26.436450325537947,22.532780443692822,43.10769230769231,56.89230769230769
199,62,37,25,12,50,127,123,22.129032258064516,26.272298118757803,20.978390318813023,42.53225806451613,57.46774193548387
200,65,37,28,14,51,127,124,22.0,25.635284953732683,24.45702273857501,42.784615384615385,57.215384615384615
201,66,39,27,16,50,127,124,22.666666666666668,26.120728497448297,21.500483623763824,42.74242424242424,57.25757575757576
202,68,40,28,18,50,127,124,23.0,26.560388663724094,20.704317218628848,43.338235294117645,56.661764705882355
203,71,42,29,18,53,127,124,23.028169014084508,26.840844089002882,20.652113657475986,44.352112676056336,55.647887323943664
204,74,43,31,18,56,127,124,23.094594594594593,28.67175840537295,18.395809162194617,43.513513513513516,56.486486486486484
205,75,42,33,18,57,128,125,22.493333333333332,28.515559770839662,17.764440229160332,45.0,55.0
206,78,44,34,18,60,128,125,22.628205128205128,29.243238630305505,17.461889574822703,45.82051282051282,54.17948717948718
207,78,46,32,18,60,130,125,22.32051282051282,30.301686936546993,15.400598678846324,45.07692307692308,54.92307692307692
208,76,43,33,16,60,132,127,21.31578947368421,29.00859049134708,16.396531589932337,45.69736842105263,54.30263157894737
209,75,45,30,16,59,132,128,21.986666666666668,28.098025822461388,16.87530751087195,45.18666666666667,54.81333333333333
210,77,48,29,16,61,132,128,22.415584415584416,30.13196855992803,17.322576894617434,45.51948051948052,54.48051948051948
211,77,46,31,16,61,133,130,22.207792207792206,30.931630514700952,16.990447407376966,45.753246753246756,54.246753246753244
212,74,45,29,15,59,134,132,22.243243243243242,30.437382618627602,15.495243863295817,45.391891891891895,54.608108108108105
213,71,42,29,13,58,136,134,21.56338028169014,29.346036674809472,17.45669699821181,45.971830985915496,54.028169014084504
214,69,41,28,15,54,136,136,22.057971014492754,27.529536229415093,19.65886956768636,45.84057971014493,54.15942028985507
215,67,38,29,14,53,138,137,21.47761194029851,26.363060642223413,20.84589503438258,45.73134328358209,54.26865671641791
216,69,42,27,14,55,138,137,21.855072463768117,28.038269010768964,20.005209250100602,45.710144927536234,54.289855072463766
217,71,42,29,13,58,139,137,21.47887323943662,28.45017645914523,20.761091146488575,46.309859154929576,53.690140845070424
218,67,39,28,12,55,139,141,21.104477611940297,25.11180163635314,21.653237965537038,46.97014925373134,53.02985074626866
219,67,42,25,12,55,139,141,22.104477611940297,25.91224721125387,20.893722937999858,46.97014925373134,53.02985074626866
220,67,45,22,11,56,139,142,22.313432835820894,24.785002874063878,23.46847568641503,47.44776119402985,52.55223880597015
221,68,46,22,11,57,139,142,22.985294117647058,25.141524533345095,22.50553429018432,47.30882352941177,52.69117647058823
222,68,48,20,10,58,139,143,23.426470588235293,23.655782964297934,23.60706444152125,48.10294117647059,51.89705882352941
223,69,49,20,10,59,139,143,24.08695652173913,24.981047520741583,22.01895247925842,47.44927536231884,52.55072463768116
224,68,52,16,10,58,139,144,24.955882352941178,24.345408875500457,22.3898852421466,47.60294117647059,52.39705882352941
225,69,52,17,14,55,139,144,25.594202898550726,26.030725715558404,21.085216313427104,47.47826086956522,52.52173913043478
226,70,53,17,14,56,139,145,25.728571428571428,24.923490638880626,22.433652218262228,49.0,51.0
227,71,54,17,15,56,140,145,25.633802816901408,27.12657015135539,19.60582421484179,48.29577464788732,51.70422535211268
228,71,54,17,17,54,141,145,25.859154929577464,28.182997284843886,18.16911539121245,48.40845070422535,51.59154929577465
229,74,53,21,16,58,142,145,25.10810810810811,30.161219101280118,17.812334438863065,48.37837837837838,51.62162162162162
230,74,52,22,16,58,142,147,25.10810810810811,28.294580453013566,19.610824952391834,48.08108108108108,51.91891891891892
231,76,50,26,15,61,143,148,24.11842105263158,29.834889521311933,20.217742057635434,47.89473684210526,52.10526315789474
232,75,49,26,17,58,143,150,24.453333333333333,28.43947592931554,20.027190737351123,47.36,52.64
233,74,50,24,16,58,144,151,24.513513513513512,28.303653466754206,19.61526545216471,46.86486486486486,53.13513513513514
234,74,50,24,18,56,145,152,24.283783783783782,29.1681903780157,19.52099881117349,46.71621621621622,53.28378378378378
235,73,48,25,18,55,146,153,24.383561643835616,28.961435369688594,20.079660520722364,47.84931506849315,52.15068493150685
236,75,48,27,19,56,147,153,24.04,31.176454777290054,19.156878556043285,48.08,51.92
237,77,48,29,19,58,147,154,23.92207792207792,31.00800404508392,18.670849950705108,48.298701298701296,51.701298701298704
238,73,45,28,18,55,149,156,23.575342465753426,28.621750921589335,19.29356325492817,48.726027397260275,51.273972602739725
239,73,44,29,19,54,149,158,23.36986301369863,28.659906887511507,19.963716213898767,47.38356164383562,52.61643835616438
240,70,41,29,17,53,150,160,23.52857142857143,27.924434661536527,19.825802174440366,47.3,52.7
241,69,40,29,17,52,150,162,23.768115942028984,26.440305737352173,21.89922494825938,47.15942028985507,52.84057971014493
242,69,40,29,17,52,150,163,24.014492753623188,26.27938219734877,22.792774579762074,47.768115942028984,52.231884057971016
243,71,40,31,18,53,150,164,23.816901408450704,27.013184547919348,23.634702776024316,47.83098591549296,52.16901408450704
244,72,41,31,20,52,150,165,23.944444444444443,27.505791223374963,23.71318295806479,47.44444444444444,52.55555555555556
245,71,42,29,21,50,152,167,23.056338028169016,28.045873946978922,24.05508755128163,47.11267605633803,52.88732394366197
246,76,45,31,21,55,152,167,22.539473684210527,29.46958718015764,24.42514966194763,47.8421052631579,52.1578947368421
247,77,46,31,19,58,153,168,21.948051948051948,30.847901265221996,22.905345488024768,49.58441558441559,50.41558441558441
248,80,47,33,21,59,153,168,22.125,32.899363630090136,20.05063636990986,49.65,50.35
249,82,48,34,21,61,153,168,22.585365853658537,33.69975596693478,18.214878179406682,49.19512195121951,50.80487804878049
250,82,48,34,19,63,154,169,22.353658536585368,34.2629273759006,16.895609209465245,49.18292682926829,50.81707317073171
251,79,45,34,20,59,154,174,21.772151898734176,33.16573138147265,19.31159912574595,49.88607594936709,50.11392405063291
252,79,44,35,20,59,154,176,21.60759493670886,32.67455455668592,21.008989747111546,50.835443037974684,49.164556962025316
253,78,46,32,19,59,154,179,21.423076923076923,31.394538563377647,21.85845982321739,50.53846153846154,49.46153846153846
254,78,45,33,19,59,154,180,22.0,31.50165847715023,23.21629024079849,50.11538461538461,49.88461538461539
255,77,44,33,17,60,155,182,21.623376623376622,32.35620591276472,22.152950237526333,49.077922077922075,50.922077922077925
256,75,43,32,16,59,155,184,22.52,32.56665050388456,20.130200951286618,49.013333333333335,50.986666666666665
257,77,42,35,16,61,155,185,22.350649350649352,33.11897599716008,22.465438538813434,49.8051948051948,50.1948051948052
258,76,44,32,18,58,155,187,23.31578947368421,32.872098099455485,21.246322953176094,50.31578947368421,49.68421052631579
259,73,43,30,16,57,157,190,22.80821917808219,31.223624930453916,21.23409044343182,51.45205479452055,48.54794520547945
260,72,42,30,17,55,158,191,22.416666666666668,32.12728176055224,20.90049601722554,52.083333333333336,47.916666666666664
261,67,41,26,17,50,160,194,22.582089552238806,28.961727110608496,23.844243038645235,51.92537313432836,48.07462686567164
262,67,45,22,16,51,161,194,22.761194029850746,28.628547216020106,25.22219905263661,52.11940298507463,47.88059701492537
263,68,47,21,16,52,161,195,23.235294117647058,27.363000315869304,27.709015131848336,52.955882352941174,47.044117647058826
264,71,46,25,15,56,162,195,22.507042253521128,30.662857981156083,26.054779820086846,54.23943661971831,45.76056338028169
265,69,47,22,15,54,162,197,23.73913043478261,29.493160123002408,23.387585853213775,54.84057971014493,45.15942028985507
266,69,47,22,19,50,162,198,24.536231884057973,31.019455026183852,23.064565665617007,54.95652173913044,45.04347826086956
267,71,47,24,19,52,162,200,24.08450704225352,31.379079818819545,24.973032857236802,53.32394366197183,46.67605633802817
268,70,47,23,18,52,162,202,24.67142857142857,29.789454731448924,24.820634310167886,53.457142857142856,46.542857142857144
269,69,47,22,17,52,163,204,24.869565217391305,29.05839915536357,25.36738921773469,54.666666666666664,45.333333333333336
270,69,46,23,17,52,163,205,25.217391304347824,28.39427160078561,25.435878246256618,54.36231884057971,45.63768115942029
271,73,46,27,17,56,163,205,24.835616438356166,30.021713277514085,24.649519599198246,55.87671232876713,44.12328767123287
272,75,46,29,17,58,163,205,25.173333333333332,32.015059041793776,20.904940958206225,56.333333333333336,43.666666666666664
273,73,45,28,15,58,165,206,24.726027397260275,31.486222553493775,20.157614529257696,56.986301369863014,43.013698630136986
274,73,44,29,14,59,166,207,24.383561643835616,31.826866408620173,20.603252630335408,57.89041095890411,42.10958904109589
275,72,44,28,14,58,166,208,25.26388888888889,32.78088030099105,18.73300858789784,57.47222222222222,42.52777777777778
276,67,41,26,10,57,166,214,24.582089552238806,26.207719324025675,26.338313679846603,56.940298507462686,43.059701492537314
277,68,41,27,10,58,166,214,25.220588235294116,28.344204088741435,26.08226649949386,56.35294117647059,43.64705882352941
278,70,42,28,10,60,166,214,25.5,30.25765760970108,24.49948524744178,54.92857142857143,45.07142857142857
279,68,41,27,12,56,167,215,25.88235294117647,30.559885395822583,22.660972188057396,54.73529411764706,45.26470588235294
280,67,43,24,12,55,167,217,26.35820895522388,29.95211806732711,24.48501789650457,53.82089552238806,46.17910447761194
281,66,41,25,12,54,168,220,25.136363636363637,28.272485501883907,28.87616031491443,55.54545454545455,44.45454545454545
282,64,38,26,12,52,169,222,24.828125,26.712409967009517,28.640442263717873,55.484375,44.515625
283,65,42,23,12,53,169,222,25.446153846153845,29.586232760513006,25.936844162563915,55.86153846153846,44.13846153846154
284,62,40,22,11,51,170,225,24.822580645161292,26.94937953222879,26.064643240105504,55.74193548387097,44.25806451612903
285,59,39,20,9,50,171,227,24.89830508474576,24.561565360721435,28.098408149159987,54.40677966101695,45.59322033898305
286,58,39,19,9,49,171,228,26.03448275862069,24.316424713813305,28.729971487913883,54.51724137931034,45.48275862068966
287,58,40,18,9,49,171,228,27.03448275862069,24.69242733252765,29.04895197781718,54.51724137931034,45.48275862068966
288,56,41,15,8,48,174,228,26.053571428571427,24.73870883029508,29.123003922483083,54.5,45.5
289,55,40,15,10,45,174,229,27.181818181818183,22.22406159582766,31.430483858717793,54.236363636363635,45.763636363636365
290,54,41,13,10,44,176,229,26.61111111111111,21.34038149811551,32.48192188433971,54.388888888888886,45.611111111111114
291,54,40,14,9,45,177,229,26.64814814814815,22.868316681496335,31.20575739257774,54.925925925925924,45.074074074074076
292,57,41,16,9,48,177,229,26.24561403508772,23.782921202181473,31.339885815362386,54.80701754385965,45.19298245614035
293,58,41,17,9,49,177,229,26.79310344827586,24.6672527223773,28.436195553484772,54.63793103448276,45.36206896551724
294,58,42,16,9,49,177,230,27.43103448275862,25.248111311146204,27.95878524057793,53.96551724137931,46.03448275862069
295,60,43,17,11,49,177,230,27.516666666666666,26.784086156992238,27.13258050967443,53.71666666666667,46.28333333333333
296,61,44,17,11,50,177,230,28.065573770491802,27.036351857546133,25.79971371622436,52.885245901639344,47.114754098360656
297,63,47,16,13,50,177,230,28.174603174603174,28.3646575920857,24.857564630136523,53.666666666666664,46.333333333333336
298,65,47,18,13,52,177,231,27.6,27.65091434777898,25.021796901372788,53.46153846153846,46.53846153846154
299,65,45,20,15,50,180,231,26.092307692307692,27.50183034227696,25.193853737430704,55.03076923076923,44.96923076923077
300,65,42,23,15,50,183,232,24.23076923076923,26.33285456574781,27.769768243239763,55.95384615384615,44.04615384615385
301,66,41,25,14,52,184,232,23.893939393939394,27.887600444674312,24.043149972062288,55.03030303030303,44.96969696969697
302,69,41,28,14,55,184,232,23.855072463768117,30.193400898959148,22.009497651765493,55.492753623188406,44.507246376811594
303,68,40,28,14,54,184,233,24.897058823529413,30.670234975737777,19.5356473772034,55.13235294117647,44.86764705882353
304,64,35,29,11,53,185,237,24.203125,28.362246717191873,22.090878282808127,54.65625,45.34375
305,65,36,29,13,52,185,237,24.83076923076923,31.023815973981357,19.868491718326332,55.06153846153846,44.93846153846154
306,65,36,29,12,53,186,237,24.96923076923077,32.24518744817684,18.90377823971619,54.6,45.4
307,64,35,29,12,52,186,239,25.359375,30.562374962556408,21.6664398541893,54.484375,45.515625
308,64,34,30,12,52,188,240,23.796875,29.391461878935843,24.858538121064154,54.625,45.375
309,61,33,28,14,47,190,242,23.442622950819672,24.11766991039228,27.64966973006253,53.39344262295082,46.60655737704918
310,63,32,31,16,47,192,242,21.984126984126984,25.045440993893056,28.821175729987264,53.36507936507937,46.63492063492063
311,63,31,32,16,47,193,242,22.158730158730158,25.535051071595234,26.369710833166675,53.36507936507937,46.63492063492063
312,65,32,33,16,49,193,242,22.476923076923075,26.951485887586294,24.386975650875243,52.784615384615385,47.215384615384615
313,66,34,32,16,50,193,243,22.893939393939394,26.79736007559426,24.5662762880421,53.22727272727273,46.77272727272727
314,65,35,30,16,49,194,244,23.2,25.135711520809092,24.94600446444908,52.47692307692308,47.52307692307692
315,67,36,31,17,50,195,244,22.746268656716417,27.500633688986152,24.439664818476533,51.940298507462686,48.059701492537314
316,69,38,31,16,53,195,245,22.391304347826086,26.439735515032748,25.560264484967252,53.88405797101449,46.11594202898551
317,71,39,32,17,54,196,246,21.281690140845072,26.71754804560259,26.958508292425577,52.394366197183096,47.605633802816904
318,69,37,32,19,50,198,248,20.91304347826087,25.321897789372176,25.78144194345945,53.594202898550726,46.405797101449274
319,71,38,33,19,52,199,248,20.549295774647888,28.373062090236445,23.45792382525651,54.50704225352113,45.49295774647887
320,73,37,36,18,55,200,248,20.273972602739725,28.833684453557485,22.371794998497315,54.45205479452055,45.54794520547945
321,74,36,38,18,56,200,249,20.33783783783784,29.21120896774896,20.81581805927807,54.83783783783784,45.16216216216216
322,77,37,40,19,58,200,250,19.74025974025974,30.69963504564637,22.475578527061035,55.311688311688314,44.688311688311686
323,79,38,41,19,60,200,250,20.240506329113924,32.02239756515252,20.104184713328493,55.54430379746835,44.45569620253165
324,79,38,41,18,61,201,251,19.962025316455698,33.64101341285891,19.396961270688347,57.35443037974684,42.64556962025316
325,80,39,41,17,63,202,251,20.05,34.81345214699806,18.33654785300194,56.6375,43.3625
326,78,40,38,18,60,203,253,19.615384615384617,33.942221233288855,19.55777886352517,56.47435897435897,43.52564102564103
327,78,41,37,19,59,204,253,19.935897435897434,35.85584899494105,17.70819820327477,56.30769230769231,43.69230769230769
328,79,39,40,18,61,205,255,19.29113924050633,35.395553795864146,21.745356049332184,56.962025316455694,43.037974683544306
329,75,41,34,18,57,205,259,20.32,31.290910284079697,24.444876809916785,57.266666666666666,42.733333333333334
330,75,42,33,18,57,205,261,20.933333333333334,29.799936393207737,26.42395533878996,57.17333333333333,42.82666666666667
331,73,43,30,18,55,205,263,21.78082191780822,29.81127941600284,27.02433702235333,56.6986301369863,43.3013698630137
332,70,41,29,19,51,208,266,20.714285714285715,26.37256018012732,31.84172553415839,55.7,44.3
333,71,42,29,19,52,208,268,21.04225352112676,25.35609119086377,31.909310492170025,54.57746478873239,45.42253521126761
334,73,43,30,19,54,208,268,21.465753424657535,27.00144739877251,30.354716984789132,54.42465753424658,45.57534246575342
335,75,43,32,21,54,209,268,21.186666666666667,29.434231424243215,27.79243524242345,53.70666666666666,46.29333333333334
336,73,42,31,22,51,209,271,21.835616438356166,27.72705101719687,28.28676390107989,53.726027397260275,46.273972602739725
337,75,45,30,22,53,209,272,22.066666666666666,29.612058427201106,27.55839437353891,52.86666666666667,47.13333333333333
338,76,43,33,22,54,209,275,21.776315789473685,28.95066534296929,29.834030261309778,53.0921052631579,46.9078947368421
339,77,44,33,22,55,209,277,22.051948051948052,28.031672492035618,29.559681125287554,52.76623376623377,47.23376623376623
340,78,45,33,22,56,209,278,22.602564102564102,29.56654364991471,27.138584555213495,51.62820512820513,48.37179487179487
341,79,46,33,21,58,210,278,22.658227848101266,30.33026468278343,26.024165696963404,52.77215189873418,47.22784810126582
342,83,47,36,21,62,210,278,22.566265060240966,31.633127755394717,25.896992726532993,53.506024096385545,46.493975903614455
343,83,45,38,19,64,211,279,22.49397590361446,32.46407745810401,23.728693626233348,53.08433734939759,46.91566265060241
344,84,47,37,19,65,211,279,23.226190476190474,34.373113157958514,21.091172556327198,53.035714285714285,46.964285714285715
345,84,47,37,19,65,211,280,23.80952380952381,36.671572521600396,18.854757284025748,53.07142857142857,46.92857142857143
346,85,47,38,18,67,212,280,23.858823529411765,39.23800202947901,17.632586205815105,52.92941176470588,47.07058823529412
347,83,47,36,18,65,212,286,23.759036144578314,36.09405725545659,22.60606719778204,53.566265060240966,46.433734939759034
348,80,43,37,16,64,213,290,23.0,33.802855064543095,24.854530287728533,53.925,46.075
349,78,43,35,19,59,214,293,22.923076923076923,33.581758443269614,23.93311135544274,55.217948717948715,44.782051282051285
350,72,38,34,18,54,215,298,22.15277777777778,30.12983166954161,28.439683216911742,55.263888888888886,44.736111111111114
351,68,37,31,16,52,215,302,21.91176470588235,27.97585041631743,30.14538112827254,54.63235294117647,45.36764705882353
352,68,36,32,16,52,216,302,22.058823529411764,29.192861246900364,29.658981412796834,54.9264705882353,45.0735294117647
353,70,38,32,16,54,216,303,22.214285714285715,30.82987634864911,28.71298079420804,54.52857142857143,45.47142857142857
354,70,41,29,15,55,217,303,22.428571428571427,32.421791519504026,24.949637051924547,54.642857142857146,45.357142857142854
355,69,40,29,15,54,217,305,23.246376811594203,32.45591786606528,23.83393720639849,54.84057971014493,45.15942028985507
356,70,39,31,18,52,217,309,22.47142857142857,29.222294563848454,28.1306771867427,54.75714285714286,45.24285714285714
357,68,39,29,18,50,217,312,23.41176470588235,26.210686237550647,31.289313762449343,55.5735294117647,44.4264705882353
358,68,40,28,20,48,217,313,24.176470588235293,26.289740905005118,31.012156356558293,54.779411764705884,45.220588235294116
359,69,42,27,20,49,217,314,24.579710144927535,27.76361913244764,30.36681565016105,54.01449275362319,45.98550724637681
360,69,41,28,19,50,218,314,24.840579710144926,28.2962067714232,28.54148419980644,52.72463768115942,47.27536231884058
361,68,39,29,16,52,221,314,23.86764705882353,31.1525742015259,24.67095521023881,51.64705882352941,48.35294117647059
362,66,36,30,14,52,222,317,23.227272727272727,28.325237967413084,29.356580214405096,50.65151515151515,49.34848484848485
363,67,39,28,14,53,222,318,23.611940298507463,28.590737350003327,28.245083545519062,50.55223880597015,49.44776119402985
364,65,39,26,12,53,223,321,22.73846153846154,25.121995857246112,33.12415798890773,51.07692307692308,48.92307692307692
365,66,40,26,18,48,223,321,23.393939393939394,26.033044192413474,31.63362247425319,50.36363636363637,49.63636363636363
366,64,37,27,17,47,225,322,22.640625,22.317286926289647,34.451989631628045,51.109375,48.890625
367,66,36,30,17,49,226,322,22.181818181818183,22.80122600978338,35.56241035385299,52.59090909090909,47.40909090909091
368,68,37,31,17,51,226,323,22.220588235294116,22.73213481922968,36.914924004299735,52.88235294117647,47.11764705882353
369,69,39,30,17,52,227,323,22.10144927536232,23.428314732190447,35.65864178954868,52.91304347826087,47.08695652173913
370,70,39,31,17,53,227,323,22.785714285714285,25.711942303837453,31.888057696162548,52.34285714285714,47.65714285714286
371,72,40,32,17,55,227,324,22.458333333333332,27.719724236811842,31.5092961236074,52.125,47.875
372,73,41,32,16,57,228,325,22.164383561643834,27.544856573589453,31.660622878465347,51.06849315068493,48.93150684931507
373,75,43,32,17,58,229,325,21.733333333333334,29.231177743083595,29.136569819998968,51.44,48.56
374,75,42,33,16,59,230,326,21.813333333333333,28.6481965951068,28.365136738226525,50.82666666666667,49.17333333333333
375,77,44,33,16,61,230,326,22.246753246753247,30.419453067678766,26.47665082842512,50.62337662337662,49.37662337662338
376,76,42,34,16,60,231,328,22.039473684210527,29.261004119305305,27.327111846388554,50.14473684210526,49.85526315789474
377,77,43,34,16,61,231,328,22.753246753246753,32.009283254250875,23.717989473021856,50.58441558441559,49.41558441558441
378,75,41,34,13,62,233,330,21.493333333333332,30.90062380389912,24.299376196100884,49.49333333333333,50.50666666666667
379,75,43,32,13,62,233,331,21.933333333333334,30.871528784735293,24.34074065298203,49.52,50.48
380,74,40,34,15,59,234,333,22.027027027027028,31.084206437638066,24.15781726389884,49.351351351351354,50.648648648648646
381,74,40,34,17,57,235,334,21.972972972972972,30.45015545282924,25.19849319581941,50.689189189189186,49.310810810810814
382,73,40,33,18,55,236,335,21.986301369863014,30.298625831044482,24.42708311659338,49.76712328767123,50.23287671232877
383,74,39,35,18,56,238,336,20.635135135135137,32.29481152501562,23.47925230839553,50.851351351351354,49.148648648648646
384,77,43,34,18,59,238,336,20.83116883116883,33.01879407824528,21.344842285391078,51.12987012987013,48.87012987012987
385,79,44,35,18,61,238,337,21.050632911392405,33.451664984314185,19.560993243533925,50.88607594936709,49.11392405063291
386,79,41,38,17,62,238,340,20.9873417721519,31.636499699689356,21.426791439551145,51.0,49.0
387,79,41,38,16,63,238,342,21.151898734177216,31.422358604961687,20.97566456907291,50.51898734177215,49.48101265822785
388,80,45,35,15,65,238,343,21.275,31.973410096486134,20.726589903513865,51.1,48.9
389,79,45,34,14,65,238,346,21.531645569620252,31.70940093891796,21.083323775917336,51.54430379746835,48.45569620253165
390,76,43,33,12,64,240,347,21.644736842105264,33.58760130227037,16.925519655071422,52.0921052631579,47.9078947368421
391,73,41,32,11,62,241,351,21.863013698630137,31.304651351588152,20.421414340742082,51.342465753424655,48.657534246575345
392,73,42,31,13,60,242,351,22.013698630136986,33.1182167145192,17.484974004684343,51.93150684931507,48.06849315068493
393,71,40,31,12,59,242,354,22.154929577464788,31.486941551942476,20.69615703960682,51.309859154929576,48.690140845070424
394,72,41,31,11,61,242,355,22.22222222222222,30.20702009558423,22.55686879330466,51.43055555555556,48.56944444444444
395,72,42,30,11,61,242,356,23.02777777777778,31.87688083385813,19.955708323681986,51.791666666666664,48.208333333333336
396,69,40,29,11,58,242,359,23.72463768115942,28.628398582340633,23.42957243215212,53.44927536231884,46.55072463768116
397,69,40,29,11,58,242,360,24.434782608695652,28.360301188597838,25.38788402490299,53.63768115942029,46.36231884057971
398,68,40,28,9,59,244,360,24.279411764705884,28.473689581608014,23.673369241921396,53.5,46.5
399,66,39,27,11,55,245,362,24.803030303030305,26.32073287122733,24.345933795439336,53.36363636363637,46.63636363636363
400,66,44,22,13,53,245,363,25.606060606060606,26.079087584255642,25.577554323118047,53.34848484848485,46.65151515151515
401,66,46,20,17,49,246,363,25.818181818181817,28.387876419684694,24.339396307588032,52.56060606060606,47.43939393939394
402,66,50,16,17,49,246,364,26.636363636363637,27.103622860036797,25.351368253944152,53.53030303030303,46.46969696969697
403,68,52,16,17,51,246,364,26.852941176470587,26.75645880562726,26.802364723784503,52.63235294117647,47.36764705882353
404,67,50,17,16,51,248,364,26.71641791044776,26.09594932870782,25.27718499965038,52.76119402985075,47.23880597014925
405,70,51,19,16,54,248,364,26.571428571428573,27.184096942143608,25.87304591499925,53.5,46.5
406,69,51,18,15,54,249,365,26.3768115942029,26.583365306319614,24.102759636866637,53.98550724637681,46.01449275362319
407,70,50,20,14,56,251,365,25.514285714285716,26.12281408058235,26.66578032485002,53.72857142857143,46.27142857142857
408,72,50,22,13,59,252,365,25.055555555555557,27.067030935050965,25.988524620504588,53.611111111111114,46.388888888888886
409,72,49,23,12,60,253,365,25.319444444444443,27.79162775292293,23.055594469299294,53.166666666666664,46.833333333333336
410,74,50,24,14,60,253,365,25.635135135135137,30.039493682344037,22.122668479818127,53.12162162162162,46.87837837837838
411,73,50,23,14,59,255,365,25.410958904109588,32.09297407948895,18.98500792193044,52.863013698630134,47.136986301369866
412,73,48,25,13,60,257,365,24.986301369863014,33.930223955864975,18.28895412632681,54.45205479452055,45.54794520547945
413,72,47,25,12,60,258,366,25.47222222222222,33.25606500444977,17.18252749336075,54.55555555555556,45.44444444444444
414,72,48,24,12,60,258,367,26.069444444444443,33.48739285799237,18.859829364229853,54.81944444444444,45.18055555555556
415,71,47,24,12,59,259,369,25.774647887323944,32.15651265045533,22.181515518558747,53.95774647887324,46.04225352112676
416,68,42,26,11,57,261,373,24.323529411764707,29.944667290127768,25.856822382187797,53.661764705882355,46.338235294117645
417,65,40,25,9,56,262,375,24.246153846153845,28.60641789127851,25.178183023593956,52.41538461538462,47.58461538461538
418,62,37,25,7,55,263,377,23.983870967741936,27.57965591834476,27.62902855073595,51.25806451612903,48.74193548387097
419,59,36,23,6,53,263,380,25.050847457627118,23.195788403917913,31.99063667756945,50.0,50.0
420,56,35,21,5,51,264,382,25.553571428571427,19.323281165111364,36.10529026346007,49.857142857142854,50.142857142857146
421,54,36,18,4,50,266,382,25.51851851851852,16.649805175293633,38.55762814703745,49.370370370370374,50.629629629629626
422,54,36,18,4,50,266,382,26.51851851851852,17.380781592695612,38.174773962859945,49.370370370370374,50.629629629629626
423,53,37,16,4,49,267,382,27.056603773584907,17.596660694007507,37.45994307957739,49.75471698113208,50.24528301886792
424,53,40,13,4,49,267,382,28.056603773584907,16.155518950833454,39.08976406803447,49.75471698113208,50.24528301886792
425,53,40,13,5,48,268,382,28.056603773584907,15.55921785240421,39.4785179966524,50.64150943396226,49.35849056603774
426,54,41,13,5,49,268,382,28.537037037037038,16.349911174652988,38.70564438090256,50.907407407407405,49.092592592592595
427,54,42,12,7,47,268,382,29.537037037037038,14.950874642146845,39.17875498748279,50.907407407407405,49.092592592592595
428,55,45,10,7,48,268,382,30.0,15.362278052705475,39.346812856385434,50.90909090909091,49.09090909090909
429,54,45,9,9,45,269,382,30.59259259259259,15.348753615315003,37.72532045875908,51.22222222222222,48.77777777777778
430,54,46,8,9,45,269,382,31.59259259259259,16.31144595823238,36.76262811584169,51.22222222222222,48.77777777777778
431,55,46,9,9,46,270,382,31.01818181818182,16.209906573438094,37.881002517470996,51.78181818181818,48.21818181818182
432,57,48,9,9,48,270,382,30.92982456140351,16.700751651868153,37.73784483935993,51.89473684210526,48.10526315789474
433,56,47,9,8,48,272,382,30.553571428571427,16.936433021826485,34.64658590541084,52.57142857142857,47.42857142857143
434,57,47,10,8,49,273,382,30.12280701754386,17.86699527722225,33.168092442076,51.01754385964912,48.98245614035088
435,55,44,11,6,49,276,382,29.30909090909091,17.55969224142635,31.385762304028198,51.89090909090909,48.10909090909091
436,49,38,11,6,43,282,382,27.428571428571427,16.335189037499983,33.116763796336706,53.59183673469388,46.40816326530612
437,49,37,12,5,44,283,382,27.387755102040817,15.610669217303705,34.45055527249221,53.16326530612245,46.83673469387755
438,49,37,12,5,44,283,382,28.387755102040817,15.877045271737929,33.36785268744574,53.16326530612245,46.83673469387755
439,49,37,12,5,44,283,382,29.387755102040817,14.237892331605211,35.007005627578465,53.16326530612245,46.83673469387755
440,47,35,12,6,41,285,382,29.382978723404257,13.34226761297193,34.52968523610017,54.61702127659574,45.38297872340426
441,46,34,12,6,40,286,382,29.82608695652174,14.012475190927825,34.03100306994174,55.32608695652174,44.67391304347826
442,48,36,12,8,40,286,382,29.583333333333332,14.380812912663089,36.51502042067024,55.1875,44.8125
443,50,35,15,8,42,287,382,28.22,16.015773683760266,34.84422631623974,53.12,46.88
444,49,33,16,9,40,289,382,27.408163265306122,15.28473705499076,33.12119912694518,52.95918367346939,47.04081632653061
445,49,34,15,9,40,289,382,28.408163265306122,15.664034344464746,31.84616973716791,52.95918367346939,47.04081632653061
446,48,32,16,8,40,291,382,27.625,16.098413375703107,32.12139681946519,52.5,47.5
447,49,34,15,8,41,291,382,28.06122448979592,17.783125052546385,29.95156882500464,52.93877551020408,47.06122448979592
448,49,35,14,8,41,291,382,29.06122448979592,16.402628559575668,30.311657154710048,52.93877551020408,47.06122448979592
449,51,36,15,12,39,291,382,28.92156862745098,17.364326097763886,30.439595470863566,52.94117647058823,47.05882352941177
450,52,39,13,12,40,291,382,29.365384615384617,16.97352701281223,29.834165294880076,52.55769230769231,47.44230769230769
451,53,38,15,13,40,292,382,28.79245283018868,17.765715371143514,29.158812930743277,51.943396226415096,48.056603773584904
452,54,39,15,15,39,292,382,29.25925925925926,16.475565099887937,30.22813860381577,51.851851851851855,48.148148148148145
453,58,39,19,15,43,292,382,28.24137931034483,19.10369294310746,30.965272574133916,50.827586206896555,49.172413793103445
454,59,39,20,15,44,293,382,27.88135593220339,19.897195924784196,27.49263458369038,51.88135593220339,48.11864406779661
455,60,39,21,15,45,293,382,28.416666666666668,21.331632855642646,25.518367144357356,51.7,48.3
456,62,39,23,15,47,293,382,28.5,21.922631214676525,24.432207495000892,51.516129032258064,48.483870967741936
457,59,36,23,13,46,296,382,28.23728813559322,23.130320479110136,22.47702820246602,50.52542372881356,49.47457627118644
458,55,33,22,12,43,300,383,26.163636363636364,22.163341744094808,22.48209805046899,50.70909090909091,49.29090909090909
459,55,35,20,14,41,300,384,26.29090909090909,19.918384188050116,25.73616126649534,51.43636363636364,48.56363636363636
460,56,36,20,14,42,300,384,26.821428571428573,19.75804527421968,25.527669011494606,51.589285714285715,48.410714285714285
461,56,36,20,14,42,300,384,27.821428571428573,19.23811498581129,25.154742157045856,51.589285714285715,48.410714285714285
462,55,35,20,12,43,301,385,27.545454545454547,16.866101772166537,25.604465926957477,52.78181818181818,47.21818181818182
463,56,34,22,11,45,302,385,27.071428571428573,18.655535320038695,25.367771269037227,51.607142857142854,48.392857142857146
464,54,33,21,10,44,304,385,26.90740740740741,18.79816207061294,22.720356447905576,52.092592592592595,47.907407407407405
465,51,30,21,8,43,307,385,26.07843137254902,17.801194552382817,22.7316469487219,51.372549019607845,48.627450980392155
466,48,29,19,5,43,310,385,25.166666666666668,15.938839624051559,24.373660375948436,49.625,50.375
467,49,32,17,7,42,310,385,25.653061224489797,14.223086779786504,28.736096893682888,49.0,51.0
468,48,31,17,7,41,311,385,26.104166666666668,12.670416146111828,28.01708385388817,49.916666666666664,50.083333333333336
469,50,34,16,9,41,311,385,26.06,12.999796874583094,29.820203125416906,49.54,50.46
470,50,36,14,12,38,313,385,24.78,13.149575429160695,30.499565187039924,49.42,50.58
471,51,35,16,16,35,314,385,24.215686274509803,13.563959174370412,30.672012919485045,48.68627450980392,51.31372549019608
472,55,38,17,16,39,314,385,23.454545454545453,15.528736930153144,29.0167176153014,51.21818181818182,48.78181818181818
473,56,36,20,16,40,316,385,21.964285714285715,16.906536400916007,25.7507357064471,50.0,50.0
474,58,37,21,16,42,316,385,22.20689655172414,19.100230227827282,23.485976668724444,49.37931034482759,50.62068965517241
475,60,37,23,16,44,316,385,22.466666666666665,20.901133771663527,21.882199561669804,49.55,50.45
476,61,38,23,16,45,316,385,23.098360655737704,22.071705017665842,19.37091793315383,50.18032786885246,49.81967213114754
477,63,38,25,15,48,317,385,22.555555555555557,23.327294247673336,19.513975593596506,49.61904761904762,50.38095238095238
478,65,37,28,17,48,319,385,20.984615384615385,24.017408378036915,20.563319687683954,50.36923076923077,49.63076923076923
479,65,39,26,17,48,319,385,21.984615384615385,24.330252088972784,17.269747911027213,50.36923076923077,49.63076923076923
480,69,39,30,17,52,319,385,21.71014492753623,25.59289895407579,20.14623148070682,50.7536231884058,49.2463768115942
481,72,38,34,17,55,319,386,21.333333333333332,26.335670800595544,20.705995866071117,51.55555555555556,48.44444444444444
482,72,37,35,16,56,320,386,21.625,27.062351709351997,18.752523642053102,52.0,48.0
483,75,37,38,16,59,321,386,21.08,28.120228290395037,19.490003819718336,51.586666666666666,48.413333333333334
484,74,35,39,15,59,322,387,21.18918918918919,28.18173016355432,17.92637794455379,52.37837837837838,47.62162162162162
485,75,36,39,14,61,323,387,21.226666666666667,29.53875429921551,16.378704677906327,52.25333333333333,47.74666666666667
486,75,37,38,16,59,323,388,21.813333333333333,29.359798258020692,16.446954147260232,51.38666666666666,48.61333333333334
487,71,34,37,14,57,327,389,20.661971830985916,29.090161177311913,18.163359910592337,50.66197183098591,49.33802816901409
488,74,38,36,14,60,327,389,20.824324324324323,30.107165034972663,19.98742955962193,51.189189189189186,48.810810810810814
489,72,39,33,12,60,329,389,20.930555555555557,29.375818074233123,19.304737481322437,51.083333333333336,48.916666666666664
490,74,39,35,14,60,329,390,21.06756756756757,29.283163448477186,22.311431146117407,50.82432432432432,49.17567567567568
491,74,38,36,16,58,329,393,21.22972972972973,27.531332922413604,25.847045455964775,50.310810810810814,49.689189189189186
492,76,40,36,18,58,329,393,21.67105263157895,29.96792211006196,22.334709468885418,49.98684210526316,50.01315789473684
493,74,41,33,18,56,329,395,22.675675675675677,28.62343653428497,22.768957628030478,49.66216216216216,50.33783783783784
494,71,41,30,17,54,330,398,23.056338028169016,25.393036977829016,27.13759851861448,49.95774647887324,50.04225352112676
495,70,38,32,17,53,330,401,23.47142857142857,22.78522147635122,31.0433499522202,50.25714285714286,49.74285714285714
496,72,41,31,17,55,330,402,23.541666666666668,23.11036961741958,32.73685260480264,51.791666666666664,48.208333333333336
497,71,41,30,16,55,332,403,22.985915492957748,22.53213332795508,32.09986179664296,51.183098591549296,48.816901408450704
498,73,41,32,19,54,334,403,21.863013698630137,23.593847558679286,33.10487614712559,51.76712328767123,48.23287671232877
499,74,43,31,21,53,334,403,22.56756756756757,25.69613010717099,28.790356379315504,51.9054054054054,48.0945945945946
500,78,44,34,20,58,335,403,21.756410256410255,26.912972553066872,29.67677103667672,51.14102564102564,48.85897435897436
501,79,43,36,19,60,336,404,21.531645569620252,26.705886434987193,29.268797109316605,50.87341772151899,49.12658227848101
502,83,46,37,19,64,336,404,21.49397590361446,29.351534241695138,27.997863348666307,51.024096385542165,48.975903614457835
503,82,45,37,18,64,338,404,21.475609756097562,30.84834060876067,24.041903293678352,50.9390243902439,49.0609756097561
504,83,46,37,18,65,338,406,21.746987951807228,30.639386451410903,26.767647574838247,51.01204819277108,48.98795180722892
505,82,44,38,18,64,340,407,21.4390243902439,31.577533052706247,24.708645044788515,50.63414634146341,49.36585365853659
506,85,43,42,19,66,342,407,20.32941176470588,33.798998280791025,25.29642393631351,49.2,50.8
507,82,43,39,18,64,345,407,20.121951219512194,35.057848877390484,22.210443805536347,49.146341463414636,50.853658536585364
508,80,44,36,18,62,345,409,21.125,34.83544517521984,21.85205482478016,47.9875,52.0125
509,78,41,37,16,62,347,410,20.974358974358974,35.032006746945534,22.932166910731237,48.55128205128205,51.44871794871795
510,79,42,37,16,63,347,413,21.443037974683545,34.23041727112556,23.455950357712005,47.265822784810126,52.734177215189874
511,76,40,36,15,61,348,416,21.94736842105263,33.29500043127902,22.652367989773612,47.88157894736842,52.11842105263158
512,76,43,33,14,62,349,417,22.157894736842106,34.528777301778696,21.984380592958143,46.578947368421055,53.421052631578945
513,76,44,32,14,62,349,419,22.973684210526315,33.905793776432986,23.133679907777537,46.421052631578945,53.578947368421055
514,73,44,29,14,59,350,422,23.36986301369863,31.69886966789089,24.941070454109678,46.24657534246575,53.75342465753425
515,69,40,29,12,57,352,424,23.28985507246377,29.21285111120527,27.019066426530358,45.869565217391305,54.130434782608695
516,70,44,26,14,56,352,424,23.957142857142856,29.113523867776284,29.172190417938,45.92857142857143,54.07142857142857
517,69,46,23,14,55,352,426,24.304347826086957,27.25500435153903,31.417203719665558,46.11594202898551,53.88405797101449
518,67,46,21,14,53,352,429,25.238805970149254,24.91072376435645,34.450956709397246,46.37313432835821,53.62686567164179
519,67,48,19,13,54,353,429,25.402985074626866,24.51957640847326,35.830463605834964,45.43283582089552,54.56716417910448
520,66,47,19,15,51,353,431,26.09090909090909,22.800871871036552,39.82034025017557,44.65151515151515,55.34848484848485
521,64,47,17,14,50,353,433,26.609375,20.30219667285125,41.47905332714875,44.21875,55.78125
522,64,47,17,15,49,354,433,26.796875,20.116341624024088,41.43053337597591,44.421875,55.578125
523,63,47,16,14,49,355,433,27.41269841269841,19.448647924480927,40.87250760600608,44.507936507936506,55.492063492063494
524,63,47,16,14,49,355,433,28.41269841269841,18.732615730264293,41.94992395227539,44.507936507936506,55.492063492063494
525,64,46,18,14,50,356,433,28.046875,19.393408227642567,41.68471677235743,44.0,56.0
526,66,49,17,14,52,356,433,28.196969696969695,20.258543626576774,41.66569879766565,44.833333333333336,55.166666666666664
527,65,49,16,13,52,357,433,28.846153846153847,19.718948787436247,40.43489736640991,44.66153846153846,55.33846153846154
528,63,49,14,15,48,359,433,29.03174603174603,20.594610996745075,39.29297814810628,44.79365079365079,55.20634920634921
529,62,50,12,15,47,361,433,28.822580645161292,21.5272261471312,38.52116094964299,46.04838709677419,53.95161290322581
530,63,49,14,15,48,361,434,28.873015873015873,20.834606273578604,41.086042567912386,47.53968253968254,52.46031746031746
531,63,48,15,13,50,363,434,28.238095238095237,21.572470916646573,40.248897886787056,48.142857142857146,51.857142857142854
532,61,47,14,13,48,365,434,28.442622950819672,21.113683753327766,38.62402116470502,47.19672131147541,52.80327868852459
533,61,46,15,15,46,365,436,28.34426229508197,18.98066179952394,40.87179721686951,46.75409836065574,53.24590163934426
534,60,43,17,15,45,366,438,27.716666666666665,16.395506992291097,45.6544930077089,45.5,54.5
535,59,42,17,13,46,368,438,27.423728813559322,17.06153486003238,45.34524480098457,44.52542372881356,55.47457627118644
536,61,42,19,13,48,369,438,26.60655737704918,18.12610955681869,45.168972410394424,44.885245901639344,55.114754098360656
537,60,39,21,12,48,372,438,25.266666666666666,18.209835789920387,42.74963419904888,44.85,55.15
538,61,40,21,12,49,373,438,25.016393442622952,19.996520611630814,40.69200397853311,44.950819672131146,55.049180327868854
539,59,38,21,12,47,375,438,25.11864406779661,19.042214294477454,38.61880265467508,45.03389830508475,54.96610169491525
540,57,36,21,10,47,377,438,25.157894736842106,16.753691066145016,42.1594722204899,44.91228070175438,55.08771929824562
541,57,35,22,11,46,378,438,25.263157894736842,15.94017414531661,42.656317082753574,46.08771929824562,53.91228070175438
542,56,37,19,10,46,379,438,25.767857142857142,14.215574435363797,43.087996993207625,46.0,54.0
543,56,36,20,10,46,380,438,25.767857142857142,15.263816953245685,41.82546876104003,46.42857142857143,53.57142857142857
544,56,36,20,10,46,381,438,25.821428571428573,16.325838522646617,41.35273290592482,45.19642857142857,54.80357142857143
545,57,36,21,10,47,381,438,26.36842105263158,16.28855458490791,41.04477874842542,44.91228070175438,55.08771929824562
546,57,36,21,11,46,382,438,26.263157894736842,17.23448208973017,39.01229459165179,46.175438596491226,53.824561403508774
547,57,39,18,11,46,382,438,27.263157894736842,17.55797107069028,37.93325699948516,46.175438596491226,53.824561403508774
548,57,39,18,13,44,382,438,28.263157894736842,16.382725371962582,39.10850269821285,46.175438596491226,53.824561403508774
549,58,41,17,13,45,382,438,28.775862068965516,17.341658213699347,38.22730730354203,45.86206896551724,54.13793103448276
550,59,43,16,13,46,383,438,28.16949152542373,18.021119956825263,40.046676653344235,46.79661016949152,53.20338983050848
551,59,43,16,15,44,383,438,29.16949152542373,18.26064809967197,38.28172478168397,46.79661016949152,53.20338983050848
552,59,46,13,14,45,384,438,29.25423728813559,19.611818631661667,37.307135708769685,47.6271186440678,52.3728813559322
553,59,47,12,16,43,384,438,30.25423728813559,19.046284508279665,37.529986678161016,47.6271186440678,52.3728813559322
554,56,46,10,15,41,388,438,29.107142857142858,18.080214144760106,37.66875851501665,46.660714285714285,53.339285714285715
555,57,45,12,15,42,389,438,28.68421052631579,17.599452544083814,39.383003596267066,45.64912280701754,54.35087719298246
556,58,45,13,15,43,389,438,29.189655172413794,18.21766725209475,36.93750516169835,46.48275862068966,53.51724137931034
557,57,45,12,15,42,390,438,29.771929824561404,18.141820523035843,35.8932671962624,46.35087719298246,53.64912280701754
558,57,45,12,15,42,390,438,30.771929824561404,17.97107354548566,36.239452770303814,46.35087719298246,53.64912280701754
559,56,45,11,14,42,391,438,31.375,18.18563456631137,35.61793686226006,47.017857142857146,52.982142857142854
560,54,44,10,14,40,393,438,31.537037037037038,16.99369896051469,36.784078817263094,47.55555555555556,52.44444444444444
561,55,45,10,14,41,393,438,31.963636363636365,16.313023244552983,39.03243130090156,48.018181818181816,51.981818181818184
562,53,44,9,13,40,395,438,32.0377358490566,17.003644773232764,36.09781986463968,48.45283018867924,51.54716981132076
563,51,42,9,12,39,396,439,32.411764705882355,14.896425231165221,39.55455516099164,48.86274509803921,51.13725490196079
564,51,41,10,11,40,397,439,32.3921568627451,15.554256404550424,40.21044947780252,48.90196078431372,51.09803921568628
565,48,39,9,11,37,400,439,31.958333333333332,14.471105519682292,40.633061146984375,50.541666666666664,49.458333333333336
566,48,39,9,11,37,400,439,32.958333333333336,14.738544622874295,40.99062204379237,50.541666666666664,49.458333333333336
567,46,39,7,9,37,402,439,32.82608695652174,13.931095979977952,39.95225775795915,50.91304347826087,49.08695652173913
568,44,37,7,8,36,404,439,32.84090909090909,13.629082666310035,39.79117370231596,50.65909090909091,49.34090909090909
569,41,34,7,8,33,407,439,31.75609756097561,12.367937449014715,40.461330843668215,51.78048780487805,48.21951219512195
570,40,35,5,9,31,408,439,32.225,11.961046608146138,39.35587292074366,52.8,47.2
571,39,36,3,9,30,409,439,32.69230769230769,11.624973581004618,39.528872572841536,53.23076923076923,46.76923076923077
572,41,37,4,11,30,409,439,32.09756097560975,12.748093037301047,41.593370377333095,52.80487804878049,47.19512195121951
573,43,37,6,11,32,409,439,31.6046511627907,13.871370718909393,41.50072230434642,51.48837209302326,48.51162790697674
574,43,36,7,11,32,410,439,31.3953488372093,15.014436064489502,38.54370347039421,52.395348837209305,47.604651162790695
575,45,36,9,11,34,410,439,31.0,15.332375434415,40.35651345447389,52.644444444444446,47.355555555555554
576,42,33,9,9,33,413,439,30.238095238095237,12.696101502404494,39.70866040235741,52.38095238095238,47.61904761904762
577,44,32,12,11,33,414,439,28.704545454545453,15.01436486026055,41.37199877610309,50.90909090909091,49.09090909090909
578,45,33,12,11,34,414,439,29.066666666666666,14.457047155450995,39.965175066771224,51.31111111111111,48.68888888888889
579,47,33,14,13,34,414,439,28.829787234042552,14.923823424394413,39.43787870326516,51.148936170212764,48.851063829787236
580,49,34,15,15,34,414,439,28.653061224489797,15.918985379718016,38.16264727334321,50.69387755102041,49.30612244897959
581,51,34,17,15,36,414,439,28.529411764705884,16.99506092260578,36.730429273472645,49.294117647058826,50.705882352941174
582,51,33,18,15,36,415,439,28.49019607843137,16.80845865456758,36.446443306216736,47.627450980392155,52.372549019607845
583,50,32,18,14,36,416,439,29.0,16.0417723374318,36.0182276625682,48.04,51.96
584,49,29,20,12,37,419,439,27.224489795918366,17.614060147941558,34.15199971123678,49.714285714285715,50.285714285714285
585,48,27,21,11,37,421,439,26.541666666666668,17.55860938302652,33.503890616973486,49.625,50.375
586,48,27,21,11,37,421,439,27.541666666666668,17.14787316841995,33.081293498246716,49.625,50.375
587,47,24,23,13,34,424,439,25.78723404255319,16.347752635033018,34.83217115659135,51.93617021276596,48.06382978723404
588,47,26,21,13,34,424,439,26.78723404255319,16.539065034441087,32.92902007194189,51.93617021276596,48.06382978723404
589,47,25,22,15,32,426,439,25.595744680851062,17.49816091609062,34.672051849866826,52.02127659574468,47.97872340425532
590,50,26,24,19,31,427,439,24.0,18.242978639041397,35.101311086933634,51.16,48.84
591,52,28,24,19,33,427,439,24.076923076923077,19.365042379032854,33.44264992865945,51.15384615384615,48.84615384615385
592,53,26,27,18,35,429,439,22.566037735849058,20.258912117300934,31.68448410911416,49.0,51.0
593,55,28,27,18,37,429,439,22.745454545454546,20.745775102564807,31.654224897435196,48.14545454545455,51.85454545454545
594,56,29,27,17,39,430,439,22.321428571428573,19.62528756169345,32.41034657705864,48.232142857142854,51.767857142857146
595,56,28,28,16,40,432,439,21.410714285714285,19.88630307098185,34.27441121473244,48.17857142857143,51.82142857142857
596,59,30,29,18,41,432,439,21.322033898305083,21.208710784729593,34.36756040171109,47.50847457627118,52.49152542372882
597,58,31,27,16,42,434,439,20.724137931034484,21.87265510290596,32.00319570625307,48.41379310344828,51.58620689655172
598,58,31,27,16,42,434,440,20.96551724137931,21.162454827231393,32.83599529467399,48.48275862068966,51.51724137931034
599,60,30,30,17,43,435,440,20.116666666666667,22.285354611960773,32.84797872137256,48.63333333333333,51.36666666666667
600,63,31,32,17,46,435,440,20.158730158730158,23.244967677776692,33.00900057619156,48.333333333333336,51.666666666666664
601,62,31,31,15,47,437,440,19.64516129032258,24.29886354435249,32.7979106491959,46.806451612903224,53.193548387096776
602,61,30,31,15,46,438,440,20.131147540983605,24.685784126628807,30.31425764475904,46.08196721311475,53.91803278688525
603,63,32,31,15,48,438,440,20.49206349206349,23.413692092250855,33.61805393949517,45.857142857142854,54.142857142857146
604,63,31,32,15,48,439,440,20.61904761904762,23.839429162009758,33.58194547993938,45.77777777777778,54.22222222222222
605,64,33,31,15,49,439,440,21.296875,23.62337961560857,34.06412038439143,46.0,54.0
606,65,36,29,15,50,439,440,21.96923076923077,24.699758667794836,32.50024133220517,45.61538461538461,54.38461538461539
607,64,36,28,14,50,439,442,22.421875,23.367863892057386,34.100886107942614,44.984375,55.015625
608,63,36,27,15,48,442,442,20.904761904761905,25.724670958781694,31.767392533281797,44.285714285714285,55.714285714285715
609,62,37,25,15,47,442,444,21.177419354838708,24.784699843088955,32.60239693110459,44.306451612903224,55.693548387096776
610,59,35,24,14,45,444,445,20.796610169491526,24.319357605412456,32.134781085474266,42.88135593220339,57.11864406779661
611,57,35,22,12,45,445,446,20.912280701754387,21.531016730667545,34.626878006174564,42.70175438596491,57.29824561403509
612,58,38,20,12,46,445,446,21.551724137931036,20.827186762178638,36.36246841023515,43.6551724137931,56.3448275862069
613,60,39,21,16,44,445,447,21.216666666666665,19.896953841443004,39.953046158556994,44.7,55.3
614,59,39,20,15,44,446,447,21.71186440677966,19.79573093256572,37.339862287773265,44.220338983050844,55.779661016949156
615,61,42,19,19,42,446,447,22.0,20.071177068354164,38.912429489022884,44.721311475409834,55.278688524590166
616,63,42,21,22,41,447,447,21.49206349206349,19.909344016456053,39.376370269258224,44.3968253968254,55.6031746031746
617,67,44,23,22,45,447,447,21.208955223880597,21.553563181413836,36.89419801261601,44.417910447761194,55.582089552238806
618,72,45,27,22,50,447,447,20.73611111111111,24.19229502188743,34.6549272003348,45.361111111111114,54.638888888888886
619,73,46,27,24,49,447,447,21.45205479452055,25.405677972896434,29.909390520254245,45.75342465753425,54.24657534246575
620,78,48,30,24,54,447,447,21.076923076923077,27.755697752604547,28.705840708933913,47.26923076923077,52.73076923076923
621,81,49,32,26,55,447,447,21.296296296296298,29.92636552025563,25.740301146411042,48.51851851851852,51.48148148148148
622,84,49,35,28,56,447,448,21.154761904761905,31.531645559262536,25.289783012166037,48.32142857142857,51.67857142857143
623,86,50,36,30,56,447,448,21.662790697674417,33.0563530010082,22.466902812945293,48.348837209302324,51.651162790697676
624,88,50,38,30,58,449,448,21.0,35.10244497172025,20.888731707406055,49.18181818181818,50.81818181818182
625,91,51,40,30,61,449,448,21.307692307692307,38.32304337274599,17.105528055825435,49.48351648351648,50.51648351648352
626,94,50,44,29,65,449,450,21.19148936170213,40.64434873036126,15.823736376021717,49.276595744680854,50.723404255319146
627,94,48,46,28,66,450,454,21.074468085106382,39.48279105366368,14.827917313667257,49.340425531914896,50.659574468085104
628,91,43,48,22,69,454,457,19.54945054945055,41.29540563320163,10.146228216049813,51.37362637362637,48.62637362637363
629,89,41,48,21,68,454,462,19.43820224719101,40.51821529458259,10.56794563998323,51.662921348314605,48.337078651685395
630,90,40,50,21,69,454,464,19.788888888888888,42.48816270687193,9.123712618616823,50.5,49.5
631,89,40,49,20,69,454,466,20.46067415730337,44.382387963600664,6.404128890331919,50.57303370786517,49.42696629213483
632,84,40,44,20,64,455,472,21.107142857142858,41.864161034250635,7.919039338255973,51.88095238095238,48.11904761904762
633,78,40,38,19,59,457,477,21.743589743589745,39.25607135894563,11.929198267823553,52.666666666666664,47.333333333333336
634,76,43,33,19,57,457,482,22.539473684210527,36.93240366734639,14.799677664543747,51.973684210526315,48.026315789473685
635,78,46,32,19,59,457,483,22.756410256410255,38.292982242819654,13.450607500770092,52.34615384615385,47.65384615384615
636,72,40,32,21,51,457,492,23.65277777777778,30.822745290075975,21.34189199277982,51.513888888888886,48.486111111111114
637,73,41,32,21,52,457,493,24.054794520547944,31.107464408741766,21.098015043313037,50.917808219178085,49.082191780821915
638,73,39,34,21,52,458,496,23.589041095890412,28.38248020144264,24.790992248086003,50.71232876712329,49.28767123287671
639,75,40,35,21,54,458,496,23.96,29.538129119921777,23.568537546744896,50.4,49.6
640,75,40,35,20,55,459,496,24.213333333333335,31.498604379219916,20.36806228744675,50.653333333333336,49.346666666666664
641,73,39,34,20,53,462,496,23.698630136986303,31.702275166318145,20.311423463818844,50.67123287671233,49.32876712328767
642,72,39,33,18,54,465,496,22.76388888888889,31.538332094048208,19.98015367655755,50.56944444444444,49.43055555555556
643,72,38,34,20,52,465,498,22.805555555555557,30.77786168460885,20.624916093168924,51.22222222222222,48.77777777777778
644,71,39,32,19,52,466,500,22.943661971830984,27.98655875524359,23.04161025884092,50.056338028169016,49.943661971830984
645,69,35,34,24,45,467,503,22.014492753623188,25.313451473756913,24.81805852376959,48.42028985507246,51.57971014492754
646,71,37,34,24,47,467,504,22.08450704225352,24.68979607027756,26.113020831130893,48.63380281690141,51.36619718309859
647,72,37,35,23,49,468,504,22.055555555555557,25.412839536910713,24.730695215526723,50.166666666666664,49.833333333333336
648,73,37,36,21,52,470,504,21.26027397260274,27.54281021482823,21.34760074407588,50.68493150684932,49.31506849315068
649,73,36,37,19,54,472,504,20.863013698630137,27.896154323847895,20.227133347384985,50.6986301369863,49.3013698630137
650,76,39,37,19,57,472,504,21.039473684210527,28.211142192422596,21.32833149178793,50.9078947368421,49.0921052631579
651,77,41,36,21,56,473,504,20.948051948051948,29.720790794089144,18.481480120743047,50.064935064935064,49.935064935064936
652,78,39,39,21,57,473,507,20.73076923076923,28.06389394564021,21.64123416162691,51.782051282051285,48.217948717948715
653,81,41,40,21,60,473,508,20.65432098765432,28.20129850642516,21.687590382463735,51.08641975308642,48.91358024691358
654,82,43,39,20,62,474,508,20.76829268292683,30.49215369012083,18.385895090366976,51.329268292682926,48.670731707317074
655,80,43,37,18,62,476,508,20.8875,32.193923636228355,15.218576363771637,52.0375,47.9625
656,81,46,35,18,63,476,508,21.62962962962963,33.57566336887719,14.807052680505532,51.49382716049383,48.50617283950617
657,81,45,36,18,63,476,509,22.296296296296298,33.507060989912056,15.023803207618807,51.135802469135804,48.864197530864196
658,79,45,34,18,61,476,512,23.151898734177216,29.49482585422119,20.28998427236109,50.0,50.0
659,77,46,31,18,59,478,514,23.12987012987013,28.630539740894342,20.394533824338886,50.77922077922078,49.22077922077922
660,77,45,32,19,58,479,516,22.7012987012987,28.442652160687242,20.644364298769837,51.66233766233766,48.33766233766234
661,77,43,34,17,60,480,518,22.181818181818183,27.38957868612146,22.09280399876648,50.246753246753244,49.753246753246756
662,77,44,33,15,62,482,519,21.441558441558442,29.04452928752514,19.87941183892123,50.467532467532465,49.532467532467535
663,77,44,33,14,63,483,519,21.77922077922078,30.82492880375953,17.83740885857813,50.09090909090909,49.90909090909091
664,77,46,31,14,63,483,520,22.38961038961039,30.504755094506436,18.87186828211694,49.90909090909091,50.09090909090909
665,77,47,30,18,59,483,521,23.051948051948052,30.21515323557854,19.494940613785964,49.532467532467535,50.467532467532465
666,75,47,28,17,58,484,523,23.08,28.162156094976616,21.277843905023385,49.56,50.44
667,76,49,27,17,59,485,524,23.0,28.000820327342616,21.57812704107844,49.578947368421055,50.421052631578945
668,74,48,26,16,58,486,526,22.68918918918919,26.09272743063818,21.168283416745517,48.229729729729726,51.770270270270274
669,74,49,25,15,59,487,526,22.95945945945946,27.828641148516336,20.252439932564744,48.486486486486484,51.513513513513516
670,73,47,26,14,59,488,528,22.767123287671232,25.231944100025586,22.57522290640545,49.3013698630137,50.6986301369863
671,74,48,26,13,61,489,528,22.756756756756758,26.72923787712312,21.824816176930934,49.17567567567568,50.82432432432432
672,73,48,25,12,61,490,528,23.26027397260274,28.218612795006976,18.164948848828647,48.68493150684932,51.31506849315068
673,74,49,25,12,62,490,528,23.945945945945947,29.3135747882566,18.226965752283945,48.310810810810814,51.689189189189186
674,75,49,26,13,62,490,529,24.2,28.522025786106667,20.184640880560003,47.70666666666666,52.29333333333334
675,72,47,25,11,61,492,531,23.708333333333332,26.562334361316395,23.062665638683605,47.736111111111114,52.263888888888886
676,68,47,21,10,58,493,534,24.602941176470587,23.317936139588255,25.84111495765089,47.455882352941174,52.544117647058826
677,67,49,18,10,57,494,534,25.19402985074627,23.180957196330592,26.998147281281348,47.582089552238806,52.417910447761194
678,66,49,17,11,55,495,534,25.742424242424242,23.503328955293885,26.13303468106976,47.696969696969695,52.303030303030305
679,68,51,17,11,57,495,534,25.985294117647058,25.48363018248636,25.51636981751364,48.029411764705884,51.970588235294116
680,68,52,16,10,58,496,534,26.235294117647058,25.99453111392676,23.931939474308532,47.80882352941177,52.19117647058823
681,69,53,16,10,59,496,534,26.855072463768117,26.27752980564771,23.53406439725084,47.666666666666664,52.333333333333336
682,68,53,15,14,54,497,534,27.426470588235293,24.817587931563608,24.505941480201095,47.705882352941174,52.294117647058826
683,71,55,16,14,57,497,534,27.267605633802816,25.750020846828157,25.052796054580295,47.929577464788736,52.070422535211264
684,72,56,16,14,58,497,534,27.88888888888889,27.162382020491197,22.879284646175467,47.40277777777778,52.59722222222222
685,73,57,16,14,59,497,534,28.506849315068493,27.59209216554363,22.627085916648152,48.082191780821915,51.917808219178085
686,72,55,17,14,58,499,535,27.875,27.91012269798736,22.565220988096907,47.708333333333336,52.291666666666664
687,73,57,16,14,59,499,535,28.493150684931507,28.60315668156088,21.451637838987068,48.342465753424655,51.657534246575345
688,71,54,17,13,58,500,537,28.549295774647888,27.178450771640314,22.652535143852642,48.690140845070424,51.309859154929576
689,71,54,17,15,56,500,538,28.985915492957748,26.59977071597534,23.498820833320433,48.7887323943662,51.2112676056338
690,71,55,16,14,57,501,538,29.267605633802816,26.536569630578406,22.476616266639773,49.394366197183096,50.605633802816904
691,73,55,18,13,60,502,538,28.71232876712329,28.248051478809263,22.587564959546903,48.95890410958904,51.04109589041096
692,74,55,19,13,61,502,538,29.324324324324323,29.23915690744265,20.328410660124916,49.4054054054054,50.5945945945946
693,73,53,20,15,58,504,538,29.21917808219178,30.630978832175906,18.82107596234464,49.41095890410959,50.58904109589041
694,72,50,22,14,58,506,539,28.51388888888889,30.121365326504424,20.14312568183803,49.47222222222222,50.52777777777778
695,71,50,21,14,57,506,541,29.211267605633804,29.50505934352334,20.058320938166805,49.19718309859155,50.80281690140845
696,71,50,21,13,58,507,543,28.746478873239436,29.13052372053108,23.06665937806047,47.80281690140845,52.19718309859155
697,69,48,21,12,57,508,545,29.115942028985508,29.02993865001697,22.81064106012796,49.56521739130435,50.43478260869565
698,65,44,21,11,54,511,547,27.892307692307693,27.735747370857574,25.582433776320773,49.13846153846154,50.86153846153846
699,63,44,19,10,53,512,550,27.317460317460316,25.374836513921917,30.289993149888883,46.698412698412696,53.301587301587304
700,58,39,19,10,48,515,552,26.517241379310345,22.889026649880915,31.596544675237002,46.672413793103445,53.327586206896555
701,56,38,18,10,46,516,553,26.857142857142858,20.87203739492503,35.36010546473738,46.57142857142857,53.42857142857143
702,55,38,17,9,46,517,553,27.4,21.31780771365611,34.327447637166166,47.18181818181818,52.81818181818182
703,53,37,16,8,45,518,554,27.62264150943396,18.589063566658247,38.953232961325526,46.509433962264154,53.490566037735846
704,52,37,15,10,42,518,555,28.192307692307693,14.587058099219664,43.56286542902531,46.75,53.25
705,51,36,15,9,42,519,555,28.58823529411765,14.279452037656343,45.132312668226014,47.470588235294116,52.529411764705884
706,50,36,14,9,41,520,555,29.06,13.705235632228614,45.834764367771385,47.64,52.36
707,49,37,12,8,41,521,555,29.510204081632654,13.464865914014988,45.392844968503056,47.69387755102041,52.30612244897959
708,49,37,12,8,41,522,555,29.408163265306122,13.628398157873896,46.12670388294243,47.285714285714285,52.714285714285715
709,49,37,12,10,39,523,555,29.367346938775512,14.893938068043736,44.922388462568506,46.91836734693877,53.08163265306123
710,47,37,10,9,38,525,555,29.29787234042553,14.106641273177543,44.21250766299267,46.808510638297875,53.191489361702125
711,47,37,10,9,38,526,555,29.21276595744681,14.046070471820574,44.48584442179644,46.12765957446808,53.87234042553192
712,49,38,11,11,38,526,555,29.020408163265305,15.151304956103568,44.23645014593725,46.204081632653065,53.795918367346935
713,50,40,10,11,39,527,555,28.14,15.164605180250527,43.39539481974947,46.4,53.6
714,51,41,10,11,40,527,555,28.58823529411765,15.175620019632404,43.09888978428916,47.1764705882353,52.8235294117647
715,52,42,10,13,39,527,555,29.03846153846154,15.435842005701833,43.02569645583662,46.34615384615385,53.65384615384615
716,52,41,11,14,38,528,555,28.865384615384617,15.051817832815725,42.44818216718428,46.32692307692308,53.67307692307692
717,54,42,12,14,40,528,555,28.796296296296298,16.5275784446803,43.02797711087526,45.44444444444444,54.55555555555556
718,54,41,13,14,40,529,555,28.77777777777778,16.726320876025003,41.014419864715734,45.907407407407405,54.092592592592595
719,56,41,15,14,42,529,555,28.75,17.546787288802143,39.86392699691214,46.67857142857143,53.32142857142857
720,57,40,17,16,41,530,555,28.31578947368421,17.625780462274157,39.00579848509427,46.421052631578945,53.578947368421055
721,57,38,19,16,41,532,555,27.403508771929825,19.50391571539363,36.373277267062505,45.666666666666664,54.333333333333336
722,57,35,22,15,42,535,555,25.56140350877193,19.901877951762764,36.554262399114435,44.719298245614034,55.280701754385966
723,59,34,25,15,44,536,555,24.8135593220339,20.315652825590313,36.14197429305376,43.355932203389834,56.644067796610166
724,60,34,26,15,45,537,555,24.466666666666665,21.97962750567252,33.737039160994144,43.78333333333333,56.21666666666667
725,60,33,27,16,44,538,556,23.716666666666665,22.529134250917934,33.22086574908206,45.016666666666666,54.983333333333334
726,59,32,27,16,43,538,557,24.305084745762713,20.84082280145213,33.80324499515803,45.03389830508475,54.96610169491525
727,56,28,28,14,42,540,559,23.0,18.87885376951237,36.65686051620191,46.160714285714285,53.839285714285715
728,55,30,25,13,42,541,559,23.454545454545453,17.56869271626775,35.77700443001872,46.29090909090909,53.70909090909091
729,57,31,26,13,44,542,559,22.68421052631579,19.10494478467983,36.08812064038152,47.87719298245614,52.12280701754386
730,57,31,26,13,44,543,559,22.49122807017544,19.84619904439232,33.15380095560768,47.49122807017544,52.50877192982456
731,59,32,27,13,46,543,559,22.728813559322035,21.323222264490454,33.74457434567904,46.91525423728814,53.08474576271186
732,59,33,26,13,46,543,559,23.728813559322035,22.401874022280932,30.971007333651272,46.91525423728814,53.08474576271186
733,60,33,27,13,47,543,559,24.333333333333332,23.098474102237187,31.434859231096144,46.416666666666664,53.583333333333336
734,58,32,26,13,45,546,559,23.396551724137932,22.707887079156034,33.822161317072535,47.189655172413794,52.810344827586206
735,60,33,27,14,46,546,560,22.783333333333335,22.029704114873265,37.8369625517934,47.11666666666667,52.88333333333333
736,60,34,26,15,45,546,562,22.166666666666668,20.504711458821724,37.91195520784494,46.36666666666667,53.63333333333333
737,59,34,25,15,44,546,564,21.93220338983051,18.576044957256713,38.91355853633873,44.610169491525426,55.389830508474574
738,59,36,23,17,42,547,564,22.0,18.453472345503855,38.47769491763929,43.644067796610166,56.355932203389834
739,61,38,23,19,42,547,564,22.278688524590162,19.25172579439132,38.2728643695431,44.21311475409836,55.78688524590164
740,62,40,22,21,41,547,564,22.919354838709676,19.265556903965035,36.91186245087368,43.903225806451616,56.096774193548384
741,63,41,22,21,42,547,564,23.555555555555557,20.046509302578198,35.540792284723395,43.46031746031746,56.53968253968254
742,65,41,24,23,42,548,564,23.03076923076923,21.690688686796474,34.75047200058296,44.52307692307692,55.47692307692308
743,67,42,25,23,44,549,564,22.55223880597015,21.39961008843409,35.39143468768531,43.56716417910448,56.43283582089552
744,69,41,28,22,47,550,564,22.159420289855074,21.90400364934936,34.42932968398398,43.6231884057971,56.3768115942029
745,69,42,27,23,46,551,564,22.405797101449274,22.764813254749594,31.56852007858374,44.15942028985507,55.84057971014493
746,70,43,27,23,47,552,564,22.357142857142858,24.553841258274453,29.34615874172555,43.68571428571428,56.31428571428572
747,70,43,27,21,49,553,565,21.857142857142858,25.810546829027214,27.575167456687073,42.32857142857143,57.67142857142857
748,70,41,29,20,50,555,565,21.4,27.53406703321587,24.570829970824263,41.7,58.3
749,70,41,29,20,50,555,565,22.4,28.951603576322306,22.319824995106263,41.7,58.3
750,68,38,30,18,50,556,569,21.073529411764707,26.40564874641976,26.371114184435243,41.80882352941177,58.19117647058823
751,68,39,29,18,50,557,570,20.794117647058822,25.980316256678634,27.152036684497837,41.1764705882353,58.8235294117647
752,69,40,29,20,49,557,571,20.985507246376812,26.888369132418973,26.20330039873336,41.710144927536234,58.289855072463766
753,66,38,28,19,47,557,574,20.954545454545453,24.481028578383558,28.534122936767957,40.77272727272727,59.22727272727273
754,65,37,28,17,48,557,576,21.092307692307692,23.54688762153954,30.49817957076923,41.2,58.8
755,64,37,27,16,48,558,577,20.875,21.570396964224276,31.885020645418955,41.796875,58.203125
756,68,37,31,16,52,558,577,20.647058823529413,23.727130852881245,32.831692676530515,41.4264705882353,58.5735294117647
757,70,37,33,16,54,558,578,20.428571428571427,23.86672726351463,31.033272736485372,40.714285714285715,59.285714285714285
758,72,40,32,16,56,558,578,20.86111111111111,24.92959698842975,30.27873634490358,40.80555555555556,59.19444444444444
759,73,43,30,16,57,558,578,21.575342465753426,26.651048406651082,28.184568031705073,41.136986301369866,58.863013698630134
760,74,46,28,18,56,558,578,22.283783783783782,29.003441259736544,25.496558740263456,40.648648648648646,59.351351351351354
761,76,46,30,20,56,559,579,21.407894736842106,31.195419204709065,24.469985410833257,41.56578947368421,58.43421052631579
762,79,47,32,20,59,559,579,21.59493670886076,32.16376230021065,22.36788326940961,42.21518987341772,57.78481012658228
763,81,49,32,19,62,559,580,21.641975308641975,32.69380626487067,22.392613488215748,42.54320987654321,57.45679012345679
764,82,49,33,18,64,559,581,21.878048780487806,32.26276835257023,21.54210969621026,42.48780487804878,57.51219512195122
765,80,46,34,17,63,559,585,21.7125,29.041718065832253,25.469073756069964,43.85,56.15
766,76,43,33,14,62,560,589,21.105263157894736,26.141198752411707,27.711008364723615,42.98684210526316,57.01315789473684
767,76,44,32,16,60,560,590,21.723684210526315,26.458824239651687,28.251709828551014,43.03947368421053,56.96052631578947
768,76,45,31,16,60,560,591,22.289473684210527,26.716947667178168,27.559368122295513,43.88157894736842,56.11842105263158
769,76,44,32,16,60,560,593,22.486842105263158,26.233600549257485,28.661136292847782,44.01315789473684,55.98684210526316
770,73,42,31,15,58,563,593,22.136986301369863,28.70728387365721,23.881757222233198,44.534246575342465,55.465753424657535
771,74,42,32,19,55,563,593,22.83783783783784,30.872746023546117,21.965091814291718,44.810810810810814,55.189189189189186
772,75,46,29,21,54,563,593,23.533333333333335,32.72150558831003,20.691827745023303,45.24,54.76
773,75,45,30,19,56,565,594,22.706666666666667,35.144755332874006,19.375244667125994,46.28,53.72
774,74,44,30,17,57,567,596,21.743243243243242,36.1478671991061,19.66294361170472,46.7027027027027,53.2972972972973
775,69,40,29,20,49,568,600,21.840579710144926,33.104833165203374,21.334026050233806,49.028985507246375,50.971014492753625
776,64,37,27,18,46,569,604,21.796875,28.415628231797754,25.50624676820225,50.515625,49.484375
777,62,38,24,18,44,569,607,22.306451612903224,25.98655165886656,30.01344834113344,50.983870967741936,49.016129032258064
778,62,39,23,18,44,571,607,21.5,28.76950811023012,26.26274995428601,50.854838709677416,49.145161290322584
779,62,42,20,18,44,571,608,21.838709677419356,28.420684780304516,25.724476510018068,50.38709677419355,49.61290322580645
780,65,42,23,20,45,571,609,21.215384615384615,29.517755696452557,28.601096831485027,50.292307692307695,49.707692307692305
781,66,41,25,19,47,571,611,20.651515151515152,27.20921171766329,30.525001994649188,50.24242424242424,49.75757575757576
782,70,41,29,19,51,571,611,20.47142857142857,28.28850374678312,31.18292482464545,49.91428571428571,50.08571428571429
783,73,42,31,21,52,571,611,20.63013698630137,27.703200376713838,31.200909212327257,49.465753424657535,50.534246575342465
784,73,42,31,20,53,573,612,19.671232876712327,28.741241539974098,29.951512653768948,50.57534246575342,49.42465753424658
785,75,42,33,22,53,573,612,20.14666666666667,32.10083605980442,26.65916394019557,50.38666666666666,49.61333333333334
786,74,39,35,20,54,575,614,18.91891891891892,33.66264416268715,25.62162737677008,50.0,50.0
787,76,40,36,19,57,576,615,18.644736842105264,36.218702298958156,22.912876648410258,50.86842105263158,49.13157894736842
788,79,39,40,24,55,576,616,18.468354430379748,38.06772984328919,21.109485346584233,50.08860759493671,49.91139240506329
789,83,42,41,24,59,576,616,18.57831325301205,40.76210936728523,18.707770150787063,50.734939759036145,49.265060240963855
790,84,39,45,25,59,576,620,18.071428571428573,40.21341523793701,19.099852340335985,52.476190476190474,47.523809523809526
791,78,36,42,20,58,576,628,17.307692307692307,35.52361077895647,20.96990818166222,53.14102564102564,46.85897435897436
792,78,35,43,20,58,576,630,17.833333333333332,36.675704487360576,21.747372435716343,52.23076923076923,47.76923076923077
793,78,33,45,18,60,577,632,17.58974358974359,37.82002857696024,21.8209970640654,50.52564102564103,49.47435897435897
794,74,32,42,17,57,577,637,18.04054054054054,34.56900085881668,25.840608810111956,51.391891891891895,48.608108108108105
795,73,34,39,17,56,577,640,19.0,34.402241527667634,25.929991156471527,51.3013698630137,48.6986301369863
796,70,35,35,16,54,578,642,19.885714285714286,33.1566146849641,26.861283577206855,51.84285714285714,48.15714285714286
797,67,33,34,16,51,578,647,20.208955223880597,30.8747723388677,31.66458458166056,51.83582089552239,48.16417910447761
798,64,35,29,18,46,578,651,21.046875,26.804750732215812,35.228879148006826,51.953125,48.046875
799,60,35,25,16,44,580,653,21.116666666666667,25.01307528434497,36.71555766946336,53.75,46.25
800,58,35,23,15,43,581,654,21.29310344827586,24.979998527966117,37.76091701897531,54.56896551724138,45.43103448275862
801,58,35,23,16,42,581,656,21.0,25.02825460111828,39.95450401957138,54.775862068965516,45.224137931034484
802,58,38,20,18,40,581,657,21.79310344827586,23.44304986824104,40.83281220072449,54.01724137931034,45.98275862068966
803,59,41,18,18,41,581,659,22.016949152542374,21.900034980631016,43.25407813361073,53.16949152542373,46.83050847457627
804,61,42,19,18,43,581,659,22.295081967213115,23.23749039123397,41.77890305138897,52.704918032786885,47.295081967213115
805,64,44,20,18,46,581,659,22.25,26.222442848883013,38.168182151116994,52.40625,47.59375
806,65,45,20,20,45,581,659,22.907692307692308,26.95552215762536,36.13678553468233,52.753846153846155,47.246153846153845
807,66,44,22,19,47,581,660,22.984848484848484,29.217705234168047,35.44896143249861,52.07575757575758,47.92424242424242
808,67,43,24,20,47,582,660,22.850746268656717,29.57602135730036,33.87173983672949,51.95522388059702,48.04477611940298
809,68,43,25,19,49,582,661,23.102941176470587,30.462651568094756,33.33146607896407,51.35294117647059,48.64705882352941
810,66,43,23,18,48,583,662,23.560606060606062,30.805018753971357,31.17982973087713,51.75757575757576,48.24242424242424
811,66,41,25,16,50,584,664,22.87878787878788,31.249748116541813,31.02286102364172,52.81818181818182,47.18181818181818
812,63,38,25,20,43,584,668,22.88888888888889,26.565680740894532,34.57659835333107,53.61904761904762,46.38095238095238
813,61,36,25,18,43,585,671,22.131147540983605,25.485043790384857,36.531503703658494,52.9344262295082,47.0655737704918
814,58,34,24,16,42,587,672,21.689655172413794,24.481645968049776,36.018354031950224,52.96551724137931,47.03448275862069
815,59,34,25,16,43,587,672,22.322033898305083,24.893397083874905,36.42863681443018,52.74576271186441,47.25423728813559
816,59,32,27,16,43,587,674,22.152542372881356,23.202965526764704,38.271609950202794,52.186440677966104,47.813559322033896
817,58,33,25,16,42,587,675,22.982758620689655,21.58774734505697,38.30880437908096,51.46551724137931,48.53448275862069
818,57,31,26,16,41,588,676,22.70175438596491,20.8382530294686,40.91613293544368,49.824561403508774,50.175438596491226
819,57,32,25,17,40,589,676,22.789473684210527,21.43032272630207,39.417776758245104,48.94736842105263,51.05263157894737
820,57,34,23,16,41,590,676,22.80701754385965,20.481666350418564,40.18500031624811,49.1578947368421,50.8421052631579
821,59,37,22,17,42,591,676,22.050847457627118,20.686262368890297,40.737466444669025,49.728813559322035,50.271186440677965
822,62,37,25,17,45,591,676,21.983870967741936,21.86643841261307,39.84323900674177,48.82258064516129,51.17741935483871
823,65,39,26,17,48,591,676,21.96923076923077,23.152040168277825,37.60180598556835,50.2,49.8
824,66,39,27,19,47,591,677,22.045454545454547,23.30863228717593,36.57015559161196,50.86363636363637,49.13636363636363
825,70,42,28,21,49,591,677,21.785714285714285,25.78903230222786,35.51096769777214,49.957142857142856,50.042857142857144
826,73,43,30,21,52,591,677,21.89041095890411,26.131217724129986,33.73179597450015,49.42465753424658,50.57534246575342
827,73,46,27,21,52,591,677,22.89041095890411,26.83161146747688,30.976607710605307,49.42465753424658,50.57534246575342
828,71,42,29,18,53,593,679,21.830985915492956,27.69450624610527,29.30141957368874,49.352112676056336,50.647887323943664
829,72,43,29,17,55,594,680,21.180555555555557,28.817696448273537,28.873575749189587,49.486111111111114,50.513888888888886
830,73,41,32,15,58,595,681,20.534246575342465,28.643354565491055,28.5280829581678,47.80821917808219,52.19178082191781
831,72,39,33,14,58,595,684,20.47222222222222,26.144350755080055,31.370150878270255,47.18055555555556,52.81944444444444
832,72,40,32,14,58,595,685,20.98611111111111,25.63996140060887,31.0267052660578,46.52777777777778,53.47222222222222
833,72,39,33,14,58,595,686,21.569444444444443,25.556598361197345,31.20391853200417,47.041666666666664,52.958333333333336
834,70,37,33,14,56,596,687,21.885714285714286,26.864022001451225,30.335977998548774,46.48571428571429,53.51428571428571
835,70,39,31,16,54,596,687,22.885714285714286,28.343464558236484,28.999392584620658,46.48571428571429,53.51428571428571
836,70,40,30,16,54,596,687,23.885714285714286,28.298069533386265,29.044787609470877,46.48571428571429,53.51428571428571
837,68,39,29,16,52,598,688,23.485294117647058,29.113085714583857,28.28391076573768,46.794117647058826,53.205882352941174
838,67,39,28,18,49,599,691,22.611940298507463,26.881007242841374,31.597446664699454,45.343283582089555,54.656716417910445
839,67,40,27,18,49,599,692,23.19402985074627,25.307211920659935,32.782340318146034,45.582089552238806,54.417910447761194
840,64,39,25,17,47,601,693,23.03125,25.61142377356896,29.923863727738322,45.65625,54.34375
841,64,41,23,16,48,602,694,22.703125,25.148554679884604,31.929570320115403,44.484375,55.515625
842,64,40,24,16,48,603,696,21.421875,24.256882312317472,33.10527485473352,45.765625,54.234375
843,65,41,24,15,50,603,697,21.523076923076925,24.06703070877792,32.94835390660669,45.90769230769231,54.09230769230769
844,65,41,24,14,51,604,697,21.73846153846154,24.36414910954919,31.389697044296966,46.0,54.0
845,68,43,25,16,52,604,697,21.779411764705884,24.020741867895595,33.53808166151617,44.279411764705884,55.720588235294116
846,70,47,23,16,54,604,697,22.15714285714286,24.629244113955053,31.342184457473515,45.2,54.8
847,71,49,22,15,56,605,697,22.014084507042252,25.48071042070379,31.19534591732438,44.774647887323944,55.225352112676056
848,71,48,23,13,58,606,698,21.619718309859156,25.47103922725851,28.644098405942923,45.15492957746479,54.84507042253521
849,69,45,24,12,57,608,699,21.057971014492754,25.739228720552596,27.803751307439185,43.18840579710145,56.81159420289855
850,71,45,26,12,59,608,699,21.464788732394368,26.775793705453502,29.097445731166214,43.83098591549296,56.16901408450704
851,73,46,27,14,59,608,699,21.876712328767123,28.679212720966653,26.48517084067719,44.78082191780822,55.21917808219178
852,75,46,29,14,61,608,699,22.293333333333333,30.180302973898797,24.206363692767866,45.346666666666664,54.653333333333336
853,76,45,31,14,62,608,700,22.460526315789473,31.621855580077767,22.286039156764335,45.43421052631579,54.56578947368421
854,77,48,29,14,63,608,700,23.16883116883117,31.970309129789435,21.068651909171603,45.12987012987013,54.87012987012987
855,77,49,28,13,64,609,700,23.506493506493506,33.76984075553967,19.152237166538253,45.064935064935064,54.935064935064936
856,78,48,30,12,66,609,702,23.55128205128205,33.88451587671221,20.90263515489976,45.03846153846154,54.96153846153846
857,79,49,30,11,68,609,703,23.810126582278482,32.99985831346011,21.177356876413302,45.51898734177215,54.48101265822785
858,76,50,26,9,67,610,707,24.0,29.408575043545124,24.80969594502579,46.93421052631579,53.06578947368421
859,77,51,26,11,66,610,707,24.68831168831169,28.599275054163094,24.491634036745996,46.33766233766234,53.66233766233766
860,76,51,25,10,66,611,708,25.157894736842106,29.07204928028862,23.414792824974537,46.43421052631579,53.56578947368421
861,74,50,24,9,65,612,709,25.445945945945947,28.507512565008145,23.695190137694564,46.82432432432432,53.17567567567568
862,77,52,25,11,66,612,709,25.454545454545453,30.960337556591835,23.23446763821336,46.44155844155844,53.55844155844156
863,78,53,25,11,67,612,711,25.78205128205128,29.140317179629125,24.359443830070752,45.35897435897436,54.64102564102564
864,80,54,26,11,69,612,711,26.1375,28.319189155250832,24.368310844749168,45.325,54.675
865,80,54,26,11,69,612,711,27.1375,29.551469738782327,21.886030261217673,45.325,54.675
866,77,53,24,10,67,613,713,27.415584415584416,28.022750445121215,23.457769035398268,45.66233766233766,54.33766233766234
867,78,54,24,10,68,613,713,28.064102564102566,29.651855106975965,23.10455514943429,46.03846153846154,53.96153846153846
868,79,55,24,10,69,613,714,28.531645569620252,30.07502311819959,21.96295156534471,45.75949367088607,54.24050632911393
869,78,54,24,9,69,615,715,28.307692307692307,30.131329331781924,22.381480933850476,45.87179487179487,54.12820512820513
870,79,53,26,11,68,616,716,27.658227848101266,30.6856276816322,23.289055862671596,45.936708860759495,54.063291139240505
871,76,52,24,9,67,617,718,28.18421052631579,27.110974845933278,23.843537906566315,46.078947368421055,53.921052631578945
872,77,54,23,9,68,617,718,28.818181818181817,28.385524684800533,23.146942847667,46.12987012987013,53.87012987012987
873,75,55,20,8,67,618,719,29.68,28.666624881263434,22.61337511873657,47.24,52.76
874,71,53,18,6,65,622,719,29.154929577464788,28.68065610749873,20.474273469966064,47.46478873239437,52.53521126760563
875,70,52,18,6,64,622,720,29.885714285714286,27.673623458672886,22.211387787041726,47.58571428571429,52.41428571428571
876,68,50,18,5,63,623,722,29.58823529411765,24.94214016512945,26.116913554556874,47.38235294117647,52.61764705882353
877,64,46,18,5,59,627,722,29.078125,24.526287587428435,27.598995449283912,46.125,53.875
878,61,43,18,4,57,630,722,28.901639344262296,22.948635516986535,28.04509204707329,46.47540983606557,53.52459016393443
879,60,46,14,4,56,631,722,29.483333333333334,20.842337944977142,30.578109476744284,46.43333333333333,53.56666666666667
880,59,49,10,4,55,632,722,30.11864406779661,19.495420409104955,31.144359957290483,47.016949152542374,52.983050847457626
881,59,49,10,4,55,632,722,31.11864406779661,17.469202004520376,34.56469630056437,47.016949152542374,52.983050847457626
882,57,47,10,4,53,634,722,31.36842105263158,17.18724621653885,34.37415729223308,47.68421052631579,52.31578947368421
883,57,48,9,4,53,634,722,32.36842105263158,17.716207137378323,34.3715121608673,47.68421052631579,52.31578947368421
884,57,50,7,4,53,634,722,33.36842105263158,17.48615034238248,34.60156895586314,47.68421052631579,52.31578947368421
885,56,51,5,4,52,635,722,33.982142857142854,17.608038969029742,33.92765105166107,47.67857142857143,52.32142857142857
886,54,50,4,6,48,637,722,34.22222222222222,18.133674659384347,34.338045106311185,48.05555555555556,51.94444444444444
887,54,51,3,6,48,638,722,34.2037037037037,19.552078828514365,32.52199524555971,48.25925925925926,51.74074074074074
888,53,50,3,6,47,638,723,34.9622641509434,16.177665379662834,34.84120254486546,47.58490566037736,52.41509433962264
889,54,49,5,8,46,639,723,34.351851851851855,16.338159891933973,36.58776603399195,48.75925925925926,51.24074074074074
890,52,48,4,8,44,641,723,34.46153846153846,14.906229149768674,35.76684777330825,49.92307692307692,50.07692307692308
891,52,46,6,8,44,643,723,33.38461538461539,15.50214408521964,37.26345953136483,48.46153846153846,51.53846153846154
892,52,46,6,8,44,644,723,33.19230769230769,15.803598660225008,34.88401246008975,48.40384615384615,51.59615384615385
893,54,46,8,8,46,644,723,32.96296296296296,16.500012116203248,36.074061957870825,47.55555555555556,52.44444444444444
894,55,45,10,9,46,645,723,32.41818181818182,17.326395305900686,35.10996833046295,48.27272727272727,51.72727272727273
895,53,42,11,8,45,648,723,31.0,17.404555188999012,33.35013048073921,48.056603773584904,51.943396226415096
896,53,40,13,8,45,650,723,29.943396226415093,18.027086721428777,33.55781893894858,48.094339622641506,51.905660377358494
897,53,39,14,8,45,651,723,29.943396226415093,17.66007447973383,33.83049155800202,48.132075471698116,51.867924528301884
898,53,38,15,7,46,652,723,29.9811320754717,17.07658060977561,35.18757033362062,49.509433962264154,50.490566037735846
899,52,36,16,8,44,654,723,29.51923076923077,17.195163808436934,33.548443212692135,49.84615384615385,50.15384615384615
900,53,36,17,8,45,654,723,29.962264150943398,18.03216340973402,33.647081873284854,49.509433962264154,50.490566037735846
901,53,34,19,10,43,656,723,28.60377358490566,18.86517010208706,31.914374464970916,49.20754716981132,50.79245283018868
902,52,33,19,10,42,657,723,29.173076923076923,18.83526928509565,29.818576868750505,48.98076923076923,51.01923076923077
903,53,33,20,10,43,657,724,28.660377358490567,18.259956955022247,33.38280136350048,49.18867924528302,50.81132075471698
904,54,32,22,10,44,658,724,28.14814814814815,18.614934091477874,33.92210294555917,50.05555555555556,49.94444444444444
905,55,34,21,12,43,658,724,28.636363636363637,17.896163427226508,33.30383657277349,49.89090909090909,50.10909090909091
906,54,31,23,11,43,661,724,27.11111111111111,16.593242143801007,34.016184461557096,49.27777777777778,50.72222222222222
907,53,31,22,11,42,662,724,27.660377358490567,15.770548755382306,34.73888520688185,48.64150943396226,51.35849056603774
908,51,30,21,13,38,665,724,26.41176470588235,15.736012366312371,35.24568314143963,49.78431372549019,50.21568627450981
909,51,30,21,13,38,666,724,26.392156862745097,16.838305502348103,35.06365528196562,50.68627450980392,49.31372549019608
910,53,31,22,17,36,666,724,26.39622641509434,17.566474498319494,33.88635569035975,51.84905660377358,48.15094339622642
911,55,34,21,17,38,666,724,26.436363636363637,18.9614490785201,31.58400546693444,51.85454545454545,48.14545454545455
912,58,36,22,17,41,666,724,26.06896551724138,21.14883950618377,31.247712217954163,50.293103448275865,49.706896551724135
913,58,34,24,18,40,668,724,25.24137931034483,21.164927069287472,30.507486723815976,50.08620689655172,49.91379310344828
914,60,35,25,20,40,669,724,24.55,22.39694708936976,29.79647866805445,50.28333333333333,49.71666666666667
915,61,35,26,21,40,670,724,24.311475409836067,23.097607298847684,28.62370417656215,48.67213114754098,51.32786885245902
916,59,33,26,19,40,673,724,23.389830508474578,23.645151034243643,24.121799527815426,48.54237288135593,51.45762711864407
917,59,32,27,20,39,675,724,22.45762711864407,24.530506253313064,24.033722670251958,47.50847457627118,52.49152542372882
918,63,33,30,20,43,675,724,22.03174603174603,23.88282918494252,26.053678751565418,47.53968253968254,52.46031746031746
919,62,32,30,18,44,677,724,21.516129032258064,22.804427499422847,24.388856940668806,46.88709677419355,53.11290322580645
920,62,32,30,16,46,679,725,19.838709677419356,23.059064167682298,25.360290671027382,45.29032258064516,54.70967741935484
921,63,32,31,17,46,680,725,19.714285714285715,25.326341849015773,21.880007357333433,44.507936507936506,55.492063492063494
922,62,33,29,17,45,681,725,20.193548387096776,23.150928942504084,21.86520008975398,44.95161290322581,55.04838709677419
923,63,31,32,17,46,683,725,19.19047619047619,25.63977904342897,20.836411432761505,43.82539682539682,56.17460317460318
924,62,29,33,19,43,684,727,18.06451612903226,23.744965684175416,21.52922786421168,43.58064516129032,56.41935483870968
925,63,29,34,18,45,684,728,17.952380952380953,23.507196005546557,21.334073835723284,43.98412698412698,56.01587301587302
926,66,31,35,20,46,684,728,18.136363636363637,24.773706875836357,22.711141609012127,43.78787878787879,56.21212121212121
927,67,32,35,21,46,685,728,17.955223880597014,24.590202398870186,22.3500961085925,43.1044776119403,56.8955223880597
928,71,34,37,23,48,685,728,17.943661971830984,26.500756805218785,21.034454462386854,44.394366197183096,55.605633802816904
929,73,36,37,22,51,685,729,17.931506849315067,25.96805921491721,20.744269552206084,44.52054794520548,55.47945205479452
930,74,37,37,24,50,686,729,17.95945945945946,26.31959474620066,19.126351199745283,44.486486486486484,55.513513513513516
931,80,40,40,24,56,686,729,17.6125,28.175550905983595,19.599449094016403,43.5375,56.4625
932,83,41,42,24,59,686,729,17.97590361445783,29.259229496528942,16.36727652756744,43.81927710843374,56.18072289156626
933,84,42,42,23,61,686,730,18.273809523809526,30.23200559793743,13.765610747761963,44.25,55.75
934,86,44,42,24,62,686,731,18.3953488372093,32.27332293126329,13.005746836178576,44.93023255813954,55.06976744186046
935,88,44,44,23,65,686,733,17.954545454545453,32.22772655256399,13.408637083799642,45.46590909090909,54.53409090909091
936,85,42,43,20,65,686,737,17.929411764705883,29.97873002004934,14.891868840139322,44.71764705882353,55.28235294117647
937,84,44,40,20,64,686,739,18.583333333333332,30.19783440506572,14.016452019154904,45.11904761904762,54.88095238095238
938,83,44,39,20,63,686,741,19.253012048192772,31.135263677205238,13.250278491469457,46.024096385542165,53.975903614457835
939,82,44,38,22,60,686,743,19.646341463414632,31.234010116115876,13.387941103396319,45.81707317073171,54.18292682926829
940,82,44,38,21,61,686,745,20.121951219512194,31.08750007222017,14.949085293633495,45.8780487804878,54.1219512195122
941,81,43,38,18,63,686,748,19.97530864197531,30.449243884904437,16.192731423737538,44.160493827160494,55.839506172839506
942,79,43,36,22,57,686,752,20.20253164556962,28.781845494347404,15.825615040439613,43.9873417721519,56.0126582278481
943,80,45,35,22,58,686,754,20.0375,29.39673209231617,15.828267907683834,43.2125,56.7875
944,81,47,34,24,57,686,756,20.0,28.674712047200956,17.288250915762006,44.08641975308642,55.91358024691358
945,82,50,32,24,58,686,757,20.365853658536587,29.513623045987963,15.547352563768133,44.25609756097561,55.74390243902439
946,84,49,35,25,59,686,758,20.392857142857142,31.219595880341494,13.59735681316944,46.035714285714285,53.964285714285715
947,85,50,35,25,60,686,760,20.611764705882354,30.65716665654911,13.129121032691538,46.96470588235294,53.03529411764706
948,84,48,36,23,61,688,761,20.178571428571427,32.051028306187945,10.865560743362888,48.023809523809526,51.976190476190474
949,86,51,35,22,64,688,762,20.313953488372093,33.410392151981796,10.089607848018202,47.906976744186046,52.093023255813954
950,86,49,37,23,63,689,764,19.732558139534884,32.4890068450454,11.502686648207277,47.03488372093023,52.96511627906977
951,85,51,34,21,64,690,765,19.88235294117647,32.782302460171906,9.476521069239862,47.247058823529414,52.752941176470586
952,90,52,38,23,67,690,765,19.77777777777778,35.907414593851506,10.348140961704056,47.8,52.2
953,87,50,37,20,67,692,767,19.471264367816094,35.86586341365823,7.170518670490289,49.298850574712645,50.701149425287355
954,84,47,37,18,66,692,771,19.476190476190474,33.80183991412259,11.114826752544081,51.035714285714285,48.964285714285715
955,83,46,37,17,66,693,772,19.746987951807228,35.286649735458454,9.086844240445158,51.31325301204819,48.68674698795181
956,85,47,38,17,68,693,773,19.95294117647059,36.24207169986692,9.357928300133082,51.188235294117646,48.811764705882354
957,86,48,38,17,69,693,775,20.186046511627907,35.02764686786068,12.286306620511413,50.325581395348834,49.674418604651166
958,84,46,38,16,68,693,779,20.13095238095238,32.51867802303594,14.638563004134824,50.04761904761905,49.95238095238095
959,85,47,38,16,69,693,782,20.2,30.88634788705225,18.996004943252213,49.741176470588236,50.258823529411764
960,87,48,39,18,69,693,782,20.735632183908045,33.22041353562462,16.56119565977768,49.7816091954023,50.2183908045977
961,87,50,37,18,69,693,784,21.2183908045977,32.14433732399604,17.38439830818787,49.64367816091954,50.35632183908046
962,87,51,36,17,70,694,785,21.49425287356322,33.450837085611305,15.445714638526624,48.298850574712645,51.701149425287355
963,85,51,34,15,70,695,787,21.529411764705884,34.03987351908166,13.654244127977172,49.50588235294118,50.49411764705882
964,85,54,31,15,70,695,789,22.341176470588234,34.758431057632905,12.418039530602384,49.92941176470588,50.07058823529412
965,86,57,29,15,71,695,789,23.08139534883721,36.082762423137574,12.149795716397309,50.27906976744186,49.72093023255814
966,79,54,25,14,65,697,796,23.253164556962027,31.40554008238097,17.410882545640955,50.037974683544306,49.962025316455694
967,76,50,26,12,64,697,801,23.039473684210527,27.90717970750266,22.153411395566934,51.39473684210526,48.60526315789474
968,78,51,27,14,64,697,801,23.44871794871795,29.49217333951983,20.86680101945453,51.17948717948718,48.82051282051282
969,78,51,27,14,64,697,802,23.987179487179485,30.033465994585814,19.556277595157773,51.15384615384615,48.84615384615385
970,79,53,26,14,65,697,804,24.367088607594937,28.78659816816723,21.732389173604915,50.936708860759495,49.063291139240505
971,81,53,28,14,67,697,805,24.617283950617285,30.14547158088538,20.71872594997882,50.5679012345679,49.4320987654321
972,76,48,28,12,64,699,808,24.44736842105263,28.819397196010176,20.149247997935255,50.18421052631579,49.81578947368421
973,75,46,29,12,63,699,811,24.28,27.93585768156092,22.922581977521872,49.45333333333333,50.54666666666667
974,72,44,28,12,60,699,814,24.805555555555557,26.343404613352067,23.962324242668544,48.65277777777778,51.34722222222222
975,71,46,25,12,59,700,814,25.43661971830986,26.531129584646227,23.5815464716918,48.436619718309856,51.563380281690144
976,70,46,24,11,59,701,814,26.0,24.710531284297257,26.046611572845602,48.97142857142857,51.02857142857143
977,65,43,22,9,56,705,815,24.96923076923077,23.488240607778398,27.54252862299083,48.92307692307692,51.07692307692308
978,63,43,20,10,53,706,816,25.3015873015873,22.02320401161676,29.23675517352365,49.17460317460318,50.82539682539682
979,63,44,19,10,53,706,816,26.3015873015873,21.85295468935772,29.4645056281026,49.17460317460318,50.82539682539682
980,65,46,19,12,53,706,816,26.49230769230769,23.174899223026806,30.317408469280885,48.44615384615385,51.55384615384615
981,65,48,17,12,53,706,816,27.49230769230769,23.303185467439942,28.650660686406216,48.44615384615385,51.55384615384615
982,63,48,15,10,53,708,816,27.682539682539684,22.964421347185084,28.0197056369419,48.73015873015873,51.26984126984127
983,64,50,14,10,54,708,816,28.25,23.615704357802823,28.915545642197173,48.890625,51.109375
984,65,51,14,10,55,708,816,28.815384615384616,24.116174519628416,27.99151778806389,49.30769230769231,50.69230769230769
985,63,50,13,11,52,710,816,28.952380952380953,23.168480360742063,27.17991730572119,49.73015873015873,50.26984126984127
986,63,53,10,15,48,710,816,29.952380952380953,21.745256565658796,29.334108513706283,49.73015873015873,50.26984126984127
987,63,55,8,16,47,711,816,30.015873015873016,22.246094574288186,28.235439727303586,49.61904761904762,50.38095238095238
988,63,55,8,15,48,712,816,30.063492063492063,21.179738868559678,30.21708652826572,49.698412698412696,50.301587301587304
989,64,57,7,15,49,712,816,30.59375,21.71407148446211,30.301553515537893,49.9375,50.0625
990,62,55,7,14,48,713,817,31.258064516129032,19.42378300372503,31.326551700165805,49.87096774193548,50.12903225806452
991,62,55,7,14,48,713,817,32.25806451612903,18.96668846647594,31.952666372233736,49.87096774193548,50.12903225806452
992,65,55,10,14,51,713,817,31.76923076923077,20.89685033113716,31.980072745785918,49.69230769230769,50.30769230769231
993,66,55,11,14,52,713,817,32.28787878787879,22.345784119816177,29.41179163775958,48.96969696969697,51.03030303030303
994,64,52,12,13,51,716,817,31.78125,22.98657653302998,28.909248973288143,48.6875,51.3125
995,64,50,14,12,52,718,817,30.796875,24.517149375717466,28.24826757826034,49.984375,50.015625
996,64,49,15,12,52,719,818,30.609375,24.928222475682524,26.227043331420617,49.671875,50.328125
997,62,47,15,11,51,722,818,30.016129032258064,26.057175419665096,23.581870137649425,48.29032258064516,51.70967741935484
998,63,46,17,13,50,723,818,29.714285714285715,26.592683533506058,24.804141863319337,48.82539682539682,51.17460317460318
999,62,45,17,13,49,725,818,29.548387096774192,26.305851644378286,25.86147129691203,48.67741935483871,51.32258064516129
