year,Population,Adults,Children,Singles,Taken,Hunger Deaths,Old Age Deaths,Average Age,Average Hunger,Average Prowess,Average Selfishness,Average Reciprocity
0,23,20,3,6,17,0,0,18.391304347826086,15.217391304347826,35.26086956521739,49.04347826086956,50.95652173913044
1,25,20,5,6,19,0,0,17.92,13.2,36.36,46.88,53.12
2,26,20,6,6,20,0,0,18.23076923076923,11.538461538461538,37.80769230769231,45.30769230769231,54.69230769230769
3,27,20,7,6,21,0,0,18.555555555555557,11.481481481481481,37.148148148148145,45.0,55.0
4,29,20,9,6,23,0,0,18.275862068965516,12.758620689655173,37.44827586206897,44.96551724137931,55.03448275862069
5,29,20,9,6,23,0,0,19.275862068965516,10.0,36.758620689655174,44.96551724137931,55.03448275862069
6,29,20,9,6,23,0,0,20.275862068965516,10.0,36.758620689655174,44.96551724137931,55.03448275862069
7,30,20,10,6,24,0,0,20.6,11.333333333333334,36.2,46.766666666666666,53.233333333333334
8,32,20,12,6,26,0,0,20.3125,12.5,38.75,47.96875,52.03125
9,33,20,13,8,25,0,0,20.696969696969695,11.212121212121213,38.878787878787875,49.39393939393939,50.60606060606061
10,36,20,16,8,28,0,0,19.97222222222222,13.333333333333334,38.72222222222222,48.833333333333336,51.166666666666664
11,37,20,17,8,29,0,0,20.43243243243243,11.551575955561713,36.5565321525464,49.78378378378378,50.21621621621622
12,39,20,19,8,31,0,0,20.384615384615383,12.051282051282051,39.256410256410255,51.205128205128204,48.794871794871796
13,40,20,20,8,32,0,0,20.875,11.0,37.95,51.55,48.45
14,40,20,20,8,32,0,0,21.875,10.0,37.7,51.55,48.45
15,42,20,22,10,32,0,0,21.833333333333332,11.904761904761905,38.57142857142857,52.69047619047619,47.30952380952381
16,44,23,21,12,32,0,0,21.84090909090909,12.233349861094057,39.15301377526958,53.81818181818182,46.18181818181818
17,45,25,20,12,33,0,0,22.355555555555554,11.551628667658317,38.44837133234169,54.111111111111114,45.888888888888886
18,49,26,23,12,37,0,0,21.53061224489796,14.328642933879559,38.56931624979391,52.224489795918366,47.775510204081634
19,50,27,23,12,38,0,0,22.1,13.746473783531025,35.553526216468974,52.38,47.62
20,52,29,23,12,40,0,0,22.25,15.113705491290377,34.424756047171165,51.92307692307692,48.07692307692308
21,53,29,24,12,41,0,0,22.830188679245282,16.277933030749345,33.06168961076009,52.339622641509436,47.660377358490564
22,54,29,25,12,42,0,0,23.40740740740741,18.081248024926385,31.622455678777325,52.7962962962963,47.2037037037037
23,57,30,27,14,43,0,0,23.17543859649123,20.33572272609902,31.12041762477817,52.64912280701754,47.35087719298246
24,58,32,26,16,42,0,0,23.775862068965516,21.89877377460224,27.56674346677707,52.46551724137931,47.53448275862069
25,58,33,25,16,42,0,0,24.775862068965516,23.68018791468515,24.923260361176922,52.46551724137931,47.53448275862069
26,57,35,22,17,40,0,1,25.385964912280702,22.668857886419747,26.682019306562708,52.0,48.0
27,58,36,22,17,41,0,1,25.948275862068964,22.589447599878202,26.962276538052834,51.6551724137931,48.3448275862069
28,61,38,23,17,44,0,1,25.672131147540984,24.849299097030446,27.23266811608431,50.75409836065574,49.24590163934426
29,65,39,26,17,48,0,1,25.092307692307692,26.720505714505933,26.941032747032533,50.76923076923077,49.23076923076923
30,65,36,29,16,49,1,3,24.046153846153846,26.12369905663017,27.983993251062135,49.98461538461538,50.01538461538462
31,58,29,29,14,44,6,5,21.689655172413794,23.04633453001177,28.989563924220455,50.43103448275862,49.56896551724138
32,55,30,25,12,43,9,5,21.0,24.040321141443183,27.596042494920454,49.30909090909091,50.69090909090909
33,53,29,24,13,40,10,6,21.132075471698112,22.529413558197042,30.262126300058664,49.471698113207545,50.528301886792455
34,52,32,20,12,40,11,6,21.48076923076923,22.02952618691646,30.64355073616047,50.38461538461539,49.61538461538461
35,50,30,20,10,40,12,7,21.12,19.86509681666796,33.43291118122822,50.58,49.42
36,49,30,19,10,39,14,7,20.224489795918366,20.5333522721037,33.722444243159465,50.40816326530612,49.59183673469388
37,49,30,19,10,39,14,8,20.612244897959183,19.725317750350683,34.723661841486056,49.36734693877551,50.63265306122449
38,52,31,21,14,38,14,8,20.423076923076923,20.45455848658988,36.41082612879473,49.38461538461539,50.61538461538461
39,54,33,21,14,40,14,8,20.666666666666668,20.467532036711262,34.21765314847392,50.148148148148145,49.851851851851855
40,55,35,20,14,41,14,9,20.636363636363637,19.999911015630552,34.472816257096724,50.4,49.6
41,57,35,22,16,41,14,9,20.912280701754387,20.773508064177324,32.787895444594604,50.94736842105263,49.05263157894737
42,60,34,26,16,44,15,9,19.833333333333332,21.95995488471433,32.62294921894588,53.083333333333336,46.916666666666664
43,63,34,29,16,47,15,9,19.88888888888889,23.577585560564966,30.009716026736626,52.55555555555556,47.44444444444444
44,65,37,28,20,45,15,9,20.276923076923076,24.97000016002776,27.368461378433782,52.84615384615385,47.15384615384615
45,66,39,27,22,44,15,11,19.71212121212121,24.74061218414542,26.654357327898914,52.25757575757576,47.74242424242424
46,66,42,24,22,44,15,11,20.71212121212121,26.166788849755147,23.242302059335763,52.25757575757576,47.74242424242424
47,68,43,25,22,46,15,11,21.102941176470587,28.655218002713532,22.947723173757055,53.51470588235294,46.48529411764706
48,66,39,27,23,43,15,15,20.09090909090909,24.100372529751635,26.111344793137032,53.84848484848485,46.15151515151515
49,69,39,30,23,46,15,15,20.217391304347824,25.688361808240952,26.876855583063396,52.072463768115945,47.927536231884055
50,69,37,32,22,47,15,17,19.91304347826087,24.381913384474405,26.777506905380665,52.666666666666664,47.333333333333336
51,70,37,33,22,48,15,17,20.62857142857143,24.357508068352622,25.899634788790234,52.357142857142854,47.642857142857146
52,71,36,35,20,51,15,19,20.211267605633804,23.89697705167102,26.68048773706137,51.38028169014085,48.61971830985915
53,74,37,37,20,54,15,19,20.39189189189189,25.297243265425962,25.959513491330796,51.08108108108108,48.91891891891892
54,76,40,36,20,56,15,19,20.855263157894736,27.008862483715156,24.662190147863793,50.6578947368421,49.3421052631579
55,79,42,37,20,59,15,19,21.063291139240505,28.240111741922302,23.671280663140994,50.9873417721519,49.0126582278481
56,82,43,39,20,62,15,19,21.29268292682927,31.16608868119051,21.40708205051681,51.74390243902439,48.25609756097561
57,83,46,37,22,61,15,19,22.03614457831325,32.25600491217996,18.56327219625377,51.1566265060241,48.8433734939759
58,80,45,35,19,61,16,23,20.9125,31.1803999751125,18.772936970224162,50.8625,49.1375
59,80,46,34,19,61,16,24,21.4625,32.469322119660404,16.768177880339596,51.1375,48.8625
60,80,48,32,21,59,16,24,22.4625,34.03035034079524,14.582149659204765,51.1375,48.8625
61,82,50,32,21,61,16,26,21.878048780487806,34.24469415481619,16.975491118135526,50.646341463414636,49.353658536585364
62,76,43,33,18,58,19,30,20.723684210526315,32.02435479083516,18.125696177843597,50.35526315789474,49.64473684210526
63,74,42,32,16,58,19,32,21.27027027027027,32.67506697123077,17.41952762336383,49.67567567567568,50.32432432432432
64,74,45,29,16,58,19,32,22.27027027027027,33.42932698506335,16.66526760953125,49.67567567567568,50.32432432432432
65,72,44,28,19,53,19,35,22.61111111111111,31.10535868217363,18.978042056805194,50.833333333333336,49.166666666666664
66,71,46,25,21,50,20,37,22.366197183098592,29.57304388716145,19.819364822547282,50.80281690140845,49.19718309859155
67,68,44,24,20,48,21,40,22.514705882352942,27.986712702944214,20.04102797638373,50.36764705882353,49.63235294117647
68,69,47,22,20,49,21,40,23.18840579710145,28.42154228146759,19.607443225778784,49.971014492753625,50.028985507246375
69,71,47,24,21,50,21,41,22.816901408450704,28.669268541621495,19.530443055264698,50.352112676056336,49.647887323943664
70,70,47,23,22,48,21,42,23.714285714285715,28.70076806517159,18.927803363399843,50.27142857142857,49.72857142857143
71,71,48,23,22,49,21,42,24.380281690140844,30.265842362967806,18.5510590454829,50.16901408450704,49.83098591549296
72,70,51,19,22,48,21,44,25.1,29.858729204467778,19.544959488716298,50.42857142857143,49.57142857142857
73,71,52,19,22,49,21,44,25.746478873239436,30.173019766100527,19.643881642350184,50.0,50.0
74,70,52,18,21,49,22,45,25.87142857142857,28.383163444673066,20.7882651267555,48.42857142857143,51.57142857142857
75,70,51,19,20,50,22,47,25.9,27.45506419334022,21.746792172694484,48.3,51.7
76,69,50,19,18,51,23,48,25.985507246376812,26.128723052013257,22.4220015856679,47.507246376811594,52.492753623188406
77,68,49,19,18,50,24,50,25.235294117647058,24.622655485753874,24.10930199817634,45.3235294117647,54.6764705882353
78,69,49,20,18,51,26,50,24.391304347826086,25.49522115866874,23.87992318290139,46.89855072463768,53.10144927536232
79,70,49,21,20,50,26,50,25.042857142857144,26.229276318620325,21.88500939566539,47.08571428571429,52.91428571428571
80,72,48,24,19,53,27,50,24.63888888888889,27.12178379439072,21.767105094498167,47.47222222222222,52.52777777777778
81,72,49,23,19,53,27,50,25.63888888888889,26.75760939691141,20.047946158644145,47.47222222222222,52.52777777777778
82,71,50,21,18,53,27,51,26.056338028169016,26.662725203097963,19.73937634242171,46.80281690140845,53.19718309859155
83,69,49,20,16,53,29,51,26.202898550724637,28.796692082941064,16.406206467783573,47.21739130434783,52.78260869565217
84,71,49,22,16,55,29,52,26.12676056338028,29.44256475569816,18.458843695006067,48.36619718309859,51.63380281690141
85,69,47,22,15,54,31,54,25.72463768115942,28.81229506234439,19.071762908670106,48.79710144927536,51.20289855072464
86,69,47,22,15,54,31,56,26.159420289855074,28.440610094922224,20.226056571744444,49.89855072463768,50.10144927536232
87,68,46,22,17,51,31,57,27.220588235294116,27.844656714242117,19.864812014356307,50.36764705882353,49.63235294117647
88,70,47,23,17,53,31,57,27.442857142857143,27.388589065852436,21.82569664843328,51.07142857142857,48.92857142857143
89,69,45,24,17,52,33,58,27.057971014492754,27.496190541584777,21.04004134247319,51.927536231884055,48.072463768115945
90,70,45,25,17,53,33,58,27.67142857142857,28.414042868418733,19.300242845866983,52.27142857142857,47.72857142857143
91,70,47,23,19,51,34,58,27.942857142857143,28.722966042523655,19.203508349604792,52.91428571428571,47.08571428571429
92,69,47,22,18,51,35,58,28.594202898550726,29.216867917121867,18.058494401718715,52.57971014492754,47.42028985507246
93,68,45,23,16,52,36,60,28.38235294117647,27.81844373539608,21.43155626460392,54.8235294117647,45.1764705882353
94,69,48,21,16,53,36,60,28.971014492753625,28.044918082390986,20.810154381377128,54.81159420289855,45.18840579710145
95,67,47,20,16,51,37,62,29.507462686567163,24.802100527760242,23.311839898196297,56.059701492537314,43.940298507462686
96,67,48,19,16,51,38,62,29.73134328358209,25.11324684178287,23.976305397023104,57.02985074626866,42.97014925373134
97,67,48,19,18,49,39,62,29.91044776119403,25.871678977079036,22.39697773933888,57.55223880597015,42.44776119402985
98,71,48,23,18,53,39,62,29.225352112676056,27.903852608063506,21.659527673626638,57.929577464788736,42.070422535211264
99,70,46,24,17,53,41,62,29.02857142857143,28.190372232804513,18.423913481481197,57.4,42.6
100,68,45,23,18,50,44,62,28.470588235294116,30.46272097529812,17.53727902470188,56.661764705882355,43.338235294117645
101,69,45,24,17,52,44,64,27.536231884057973,29.82171075892836,18.34649372047073,58.18840579710145,41.81159420289855
102,68,45,23,16,52,44,65,28.16176470588235,30.010840994171527,16.22445312347553,58.544117647058826,41.455882352941174
103,64,40,24,13,51,48,67,26.15625,27.616347784772238,18.485236481315525,59.125,40.875
104,66,41,25,13,53,48,67,26.363636363636363,29.14867477346854,17.82102219622843,58.90909090909091,41.09090909090909
105,67,44,23,14,53,49,67,26.134328358208954,28.72056778856467,18.040626241286077,58.26865671641791,41.73134328358209
106,64,41,23,14,50,50,70,26.671875,24.966166662850213,19.251621942286242,57.265625,42.734375
107,64,40,24,15,49,51,71,26.359375,25.656111633833802,22.203263366166198,58.71875,41.28125
108,61,36,25,14,47,53,73,26.114754098360656,21.973961535913713,24.911318881241048,58.65573770491803,41.34426229508197
109,60,35,25,14,46,55,73,25.616666666666667,23.704691078918586,23.928642254414747,57.916666666666664,42.083333333333336
110,57,33,24,13,44,58,73,25.263157894736842,23.5263678666205,23.651197272743435,59.719298245614034,40.280701754385966
111,55,33,22,13,42,60,73,25.254545454545454,23.819365810698976,24.20157260646001,60.527272727272724,39.472727272727276
112,54,31,23,12,42,62,73,24.833333333333332,22.84724860035762,26.431407011073155,60.7037037037037,39.2962962962963
113,53,32,21,11,42,63,73,25.264150943396228,21.70613986357609,27.161784664725797,61.0188679245283,38.9811320754717
114,51,33,18,10,41,65,73,24.88235294117647,19.902230092724054,29.56835814257006,61.627450980392155,38.372549019607845
115,51,34,17,12,39,66,73,24.647058823529413,19.098292065402063,31.70562950322539,61.98039215686274,38.01960784313726
116,53,34,19,14,39,66,73,24.71698113207547,20.396780925183858,31.018313414438783,60.79245283018868,39.20754716981132
117,54,36,18,14,40,66,74,24.72222222222222,19.27683973045242,31.72316026954758,60.425925925925924,39.574074074074076
118,54,37,17,14,40,66,74,25.72222222222222,17.878327123392484,31.26982102475567,60.425925925925924,39.574074074074076
119,56,38,18,14,42,66,74,25.803571428571427,19.681036018113698,30.908249696172017,58.67857142857143,41.32142857142857
120,56,40,16,14,42,66,74,26.803571428571427,20.14080908266565,28.662762345905776,58.67857142857143,41.32142857142857
121,55,42,13,15,40,67,74,27.29090909090909,20.616893808534613,27.801288009647216,58.127272727272725,41.872727272727275
122,56,42,14,15,41,67,74,27.803571428571427,21.210003392733835,28.129282321551877,58.67857142857143,41.32142857142857
123,55,42,13,14,41,68,74,28.381818181818183,21.018513516353366,26.935766583202717,59.38181818181818,40.61818181818182
124,55,44,11,13,42,69,74,28.29090909090909,21.934752450729526,25.974338458361384,60.763636363636365,39.236363636363635
125,54,43,11,12,42,71,74,27.62962962962963,22.872621206113607,24.514516750759874,59.888888888888886,40.111111111111114
126,52,40,12,11,41,73,75,27.346153846153847,20.01220476593935,28.256804165895673,58.55769230769231,41.44230769230769
127,52,40,12,11,41,73,75,28.346153846153847,19.865355267661755,27.82695242464594,58.55769230769231,41.44230769230769
128,54,41,13,13,41,73,75,28.296296296296298,20.30588345016763,29.731153586869407,57.2037037037037,42.7962962962963
129,54,40,14,12,42,74,75,28.24074074074074,20.236952908845225,28.28156560967329,58.03703703703704,41.96296296296296
130,53,39,14,11,42,75,75,28.735849056603772,20.71577970589029,25.90686180354367,57.867924528301884,42.132075471698116
131,53,39,14,11,42,76,75,28.754716981132077,21.82346165358951,26.963536801667097,56.509433962264154,43.490566037735846
132,52,40,12,10,42,77,75,29.25,21.645491054630742,26.758355099215407,57.40384615384615,42.59615384615385
133,53,42,11,12,41,77,75,29.69811320754717,22.80374359685994,26.177388478611757,56.54716981132076,43.45283018867924
134,53,41,12,11,42,78,75,29.660377358490567,23.27728628757207,25.892525033182647,56.58490566037736,43.41509433962264
135,53,39,14,10,43,81,75,27.660377358490567,24.2654945782463,25.515047362835695,55.075471698113205,44.924528301886795
136,53,40,13,12,41,81,75,28.660377358490567,22.789041081386454,24.399638163896565,55.075471698113205,44.924528301886795
137,54,39,15,12,42,82,75,27.925925925925927,22.07440775072932,25.29596261964105,56.31481481481482,43.68518518518518
138,54,40,14,12,42,82,75,28.925925925925927,21.766703711340202,23.75181480717832,56.31481481481482,43.68518518518518
139,56,40,16,12,44,82,75,28.892857142857142,23.177093927966325,23.305048929176536,54.875,45.125
140,55,40,15,11,44,83,75,29.436363636363637,23.041931198935853,20.939886982882328,54.70909090909091,45.29090909090909
141,55,41,14,11,44,83,75,30.436363636363637,21.873364369404104,22.108453812414076,54.70909090909091,45.29090909090909
142,56,41,15,10,46,84,75,29.803571428571427,21.776386670981367,24.68789904330435,53.42857142857143,46.57142857142857
143,54,39,15,9,45,86,75,29.703703703703702,21.85496956085921,21.40428969840005,53.925925925925924,46.074074074074076
144,53,38,15,11,42,89,75,28.28301886792453,21.56848852292341,21.97192519895987,53.094339622641506,46.905660377358494
145,54,39,15,11,43,89,75,28.75925925925926,21.207253129649335,22.977932055535852,52.851851851851855,47.148148148148145
146,55,38,17,12,43,90,75,28.236363636363638,20.75875896566693,24.877604670696705,51.27272727272727,48.72727272727273
147,56,38,18,11,45,91,75,27.803571428571427,21.309005810119128,24.458851332738014,49.375,50.625
148,55,37,18,11,44,92,75,28.363636363636363,18.76753157709393,25.977922968360616,48.58181818181818,51.41818181818182
149,55,37,18,12,43,93,75,28.418181818181818,20.57067050732626,24.720238583582834,47.4,52.6
150,55,36,19,12,43,95,75,27.490909090909092,21.27250572735932,26.223109983452023,46.85454545454545,53.14545454545455
151,57,39,18,12,45,95,75,27.526315789473685,20.787310035861516,26.844268911506905,45.98245614035088,54.01754385964912
152,57,38,19,16,41,96,75,27.50877192982456,19.317810584957858,28.115847228858513,45.228070175438596,54.771929824561404
153,56,37,19,16,40,98,75,27.089285714285715,19.52164689559478,28.674781675833792,44.964285714285715,55.035714285714285
154,55,35,20,15,40,100,75,26.581818181818182,19.891530731228457,28.00622133086827,45.43636363636364,54.56363636363636
155,55,34,21,14,41,102,75,25.727272727272727,18.84210725898105,29.93705928379426,44.63636363636363,55.36363636363637
156,56,35,21,14,42,103,75,25.267857142857142,21.07139184394216,28.160751013200695,43.892857142857146,56.107142857142854
157,58,34,24,18,40,104,75,24.448275862068964,22.654565282744795,28.052331268979348,41.8448275862069,58.1551724137931
158,60,35,25,18,42,104,75,24.633333333333333,23.82873328342888,25.35460004990446,40.8,59.2
159,60,34,26,17,43,106,75,23.8,24.131523696926465,23.933703924392102,39.96666666666667,60.03333333333333
160,60,34,26,17,43,107,75,23.916666666666668,22.268936355108043,25.281063644891958,38.95,61.05
161,61,35,26,19,42,107,75,24.524590163934427,22.65616452303136,25.819245313034212,38.36065573770492,61.63934426229508
162,62,36,26,18,44,108,76,23.5,21.48312495839436,29.29137465451591,38.11290322580645,61.88709677419355
163,62,34,28,17,45,109,78,22.177419354838708,19.592649889800306,32.550631616482605,37.064516129032256,62.935483870967744
164,60,32,28,14,46,112,78,20.983333333333334,19.59958769045592,32.47274955683928,36.083333333333336,63.916666666666664
165,61,32,29,14,47,112,78,21.639344262295083,19.853774536843698,32.35934021725466,36.50819672131148,63.49180327868852
166,63,33,30,16,47,112,79,21.206349206349206,20.092995153284825,33.84351278322311,37.44444444444444,62.55555555555556
167,65,35,30,16,49,112,79,21.553846153846155,20.735430050134713,31.095339180634518,38.753846153846155,61.246153846153845
168,66,35,31,18,48,112,80,21.515151515151516,20.76635741055099,30.536672892479313,38.666666666666664,61.333333333333336
169,68,37,31,18,50,112,80,21.88235294117647,22.53364853203483,28.804586762082817,39.3235294117647,60.6764705882353
170,70,37,33,17,53,113,80,21.514285714285716,23.55741332979454,29.171158098776893,40.214285714285715,59.785714285714285
171,73,37,36,16,57,114,80,20.876712328767123,24.119123558398293,29.174270193883842,41.76712328767123,58.23287671232877
172,73,38,35,17,56,115,81,20.561643835616437,24.737511188242063,26.947420318607247,42.0958904109589,57.9041095890411
173,74,40,34,17,57,115,82,20.77027027027027,25.196883941578356,26.424737680043265,43.0,57.0
174,73,41,32,17,56,116,82,21.10958904109589,26.275378511703696,24.368457104734663,43.21917808219178,56.78082191780822
175,76,43,33,19,57,116,82,21.276315789473685,27.264718724197458,25.169491802118333,45.06578947368421,54.93421052631579
176,75,43,32,19,56,116,83,22.213333333333335,26.548264843578345,23.638401823088323,45.44,54.56
177,76,44,32,21,55,116,83,22.92105263157895,26.92569726578691,23.745355365792044,45.1578947368421,54.8421052631579
178,75,43,32,22,53,118,84,22.333333333333332,26.622586840509744,24.696933588548482,46.14666666666667,53.85333333333333
179,77,45,32,23,54,119,84,22.051948051948052,27.26679795373618,25.09683840990019,47.27272727272727,52.72727272727273
180,76,44,32,20,56,120,86,21.86842105263158,26.653408031296312,26.201855126598424,48.80263157894737,51.19736842105263
181,75,43,32,19,56,122,86,21.76,26.76436109962631,24.91563890037369,48.6,51.4
182,76,45,31,21,55,122,86,22.473684210526315,27.038389407167728,25.264242171779646,47.98684210526316,52.01315789473684
183,73,44,29,19,54,124,88,21.643835616438356,26.130193940585677,23.635023444545595,49.67123287671233,50.32876712328767
184,70,42,28,18,52,124,91,22.114285714285714,22.1450773297133,27.769208384572416,50.25714285714286,49.74285714285714
185,70,43,27,21,49,125,91,22.385714285714286,22.936486805804297,26.656436345089567,50.128571428571426,49.871428571428574
186,73,47,26,21,52,125,91,22.465753424657535,24.530573831876822,26.5516179489451,50.205479452054796,49.794520547945204
187,77,49,28,21,56,125,91,22.2987012987013,27.219285184909662,24.780714815090338,50.62337662337662,49.37662337662338
188,79,51,28,20,59,125,92,22.367088607594937,28.917246638942707,21.804272348399063,52.12658227848101,47.87341772151899
189,81,53,28,20,61,126,92,22.11111111111111,31.534176684305507,19.967089342943733,52.72839506172839,47.27160493827161
190,81,51,30,22,59,126,94,22.37037037037037,31.553146065467317,19.002409490088233,53.592592592592595,46.407407407407405
191,81,50,31,21,60,127,96,21.82716049382716,32.37344589777619,19.429023237969318,53.5679012345679,46.4320987654321
192,80,49,31,19,61,127,98,22.3125,31.626410989944777,19.948589010055223,54.9,45.1
193,77,44,33,17,60,127,103,21.74025974025974,26.83331544073907,24.927951160943476,55.66233766233766,44.33766233766234
194,77,44,33,17,60,129,103,21.31168831168831,28.13587181142554,25.231363065338165,56.675324675324674,43.324675324675326
195,72,40,32,13,59,132,105,20.52777777777778,26.283072768256762,25.96444750113328,57.80555555555556,42.19444444444444
196,72,42,30,12,60,133,105,20.694444444444443,28.097508785878567,24.8191578807881,57.47222222222222,42.52777777777778
197,72,44,28,14,58,133,105,21.694444444444443,28.19420319862504,24.16690791248607,57.47222222222222,42.52777777777778
198,70,44,26,16,54,133,108,22.357142857142858,25.4882359440007,27.36890691314216,57.15714285714286,42.84285714285714
199,68,42,26,14,54,134,110,22.63235294117647,23.739612449679612,29.61746647435789,57.13235294117647,42.86764705882353
200,71,43,28,14,57,134,110,22.676056338028168,25.522477966457714,29.49160654058454,56.352112676056336,43.647887323943664
201,73,44,29,14,59,134,110,23.054794520547944,27.188072428751077,27.976311132892757,55.26027397260274,44.73972602739726
202,71,45,26,14,57,134,112,23.774647887323944,25.17903134217118,29.63787848518187,55.267605633802816,44.732394366197184
203,69,44,25,14,55,135,115,23.18840579710145,23.412387712100774,33.87077115837751,55.36231884057971,44.63768115942029
204,71,46,25,18,53,135,116,23.028169014084508,24.79518569292174,32.83861712397966,55.394366197183096,44.605633802816904
205,71,50,21,18,53,135,116,24.028169014084508,26.56106292818758,28.9600638323758,55.394366197183096,44.605633802816904
206,69,48,21,19,50,136,118,23.855072463768117,26.227284939785793,29.627787523982324,55.46376811594203,44.53623188405797
207,72,50,22,21,51,136,118,23.86111111111111,28.86286389170356,27.706580552740878,54.583333333333336,45.416666666666664
208,69,48,21,21,48,137,121,23.434782608695652,27.294751392845015,29.32959111913637,52.81159420289855,47.18840579710145
209,71,48,23,21,50,137,122,23.253521126760564,27.55487675885458,31.614137325652464,52.80281690140845,47.19718309859155
210,68,45,23,22,46,138,124,23.397058823529413,25.877688314847973,30.460546979269672,52.4264705882353,47.5735294117647
211,70,46,24,22,48,138,125,23.042857142857144,26.166666646615038,31.683122666665998,52.9,47.1
212,71,45,26,24,47,138,127,22.619718309859156,25.169544764854855,33.932364370109006,52.901408450704224,47.098591549295776
213,71,43,28,23,48,139,128,22.422535211267604,26.18088675342018,31.903620288833345,53.2112676056338,46.7887323943662
214,70,42,28,23,47,139,130,22.614285714285714,24.884653091279162,32.48677548014941,53.0,47.0
215,71,40,31,24,47,140,131,21.95774647887324,25.64841016366585,33.323420822249645,53.70422535211268,46.29577464788732
216,73,44,29,24,49,140,131,22.356164383561644,26.944826735554507,30.740104771294806,53.52054794520548,46.47945205479452
217,72,43,29,21,51,142,132,21.555555555555557,26.615267506577638,30.079176937866805,54.833333333333336,45.166666666666664
218,72,41,31,21,51,142,134,21.666666666666668,26.04827734858478,31.368499231409388,54.666666666666664,45.333333333333336
219,73,43,30,21,52,142,134,22.36986301369863,27.293904348074705,30.062260035486933,54.0958904109589,45.9041095890411
220,72,43,29,19,53,143,135,22.430555555555557,27.331176924454418,29.715928701000124,54.68055555555556,45.31944444444444
221,73,42,31,19,54,143,136,22.65753424657534,27.705097386472648,29.7469574080479,54.32876712328767,45.67123287671233
222,70,39,31,18,52,144,140,21.542857142857144,25.18902221443034,31.896692071283937,53.2,46.8
223,67,37,30,17,50,147,140,21.134328358208954,24.979815751411046,29.87093051724567,52.91044776119403,47.08955223880597
224,71,38,33,19,52,147,141,20.450704225352112,25.39482514362559,33.14038612398004,51.732394366197184,48.267605633802816
225,72,41,31,19,53,147,141,21.166666666666668,26.074096809694556,29.356458745860998,51.611111111111114,48.388888888888886
226,73,42,31,21,52,147,141,21.876712328767123,27.875939007920696,27.137759622216283,51.397260273972606,48.602739726027394
227,74,44,30,20,54,148,141,21.87837837837838,29.647317296239475,26.474304325382146,51.648648648648646,48.351351351351354
228,75,47,28,22,53,148,141,22.586666666666666,30.984392836978234,24.802273829688428,52.04,47.96
229,74,47,27,22,52,148,142,23.43243243243243,31.353869451674125,24.428945679070964,51.7972972972973,48.2027027027027
230,75,49,26,22,53,148,142,24.12,32.52104344807857,23.945623218588082,52.21333333333333,47.78666666666667
231,76,51,25,22,54,148,143,24.644736842105264,34.0557748342292,22.15475148156028,52.6578947368421,47.3421052631579
232,72,53,19,23,49,148,147,26.0,32.43078875803908,22.041433464183147,54.361111111111114,45.638888888888886
233,73,52,21,21,52,148,149,25.493150684931507,32.876835071854195,21.82755969433991,56.38356164383562,43.61643835616438
234,72,51,21,22,50,150,151,24.569444444444443,30.760876927554836,24.398321114436882,55.208333333333336,44.791666666666664
235,74,50,24,22,52,150,152,24.31081081081081,32.60100229603333,22.16926797423695,54.189189189189186,45.810810810810814
236,75,50,25,24,51,150,152,24.986666666666668,33.79180736953049,19.781525963802846,53.666666666666664,46.333333333333336
237,72,48,24,26,46,151,155,25.22222222222222,31.56371946982635,22.62479438046793,54.0,46.0
238,70,47,23,26,44,151,159,24.785714285714285,28.30876841012333,24.546014428382573,52.97142857142857,47.02857142857143
239,72,46,26,25,47,152,159,24.305555555555557,28.351242689991807,25.07931286556375,53.861111111111114,46.138888888888886
240,71,46,25,24,47,153,160,23.985915492957748,27.65445661582626,23.34554338417374,54.478873239436616,45.521126760563384
241,74,47,27,24,50,153,160,24.013513513513512,29.141191535816493,22.84529495066999,55.067567567567565,44.932432432432435
242,74,46,28,24,50,154,160,24.283783783783782,29.74420272363941,20.94498646554978,54.58108108108108,45.41891891891892
243,75,45,30,22,53,156,161,23.0,31.106711766541896,22.974846429928384,54.10666666666667,45.89333333333333
244,76,46,30,22,54,157,161,23.0,31.91258157809397,21.126943139102817,54.51315789473684,45.48684210526316
245,77,44,33,21,56,157,163,22.571428571428573,33.05090025557707,19.52495128924786,55.09090909090909,44.90909090909091
246,75,43,32,21,54,157,165,23.08,31.83990978402763,17.253423549305708,55.64,44.36
247,72,42,30,19,53,158,167,23.26388888888889,33.098897961185365,16.734435372147964,56.263888888888886,43.736111111111114
248,71,40,31,20,51,159,168,23.098591549295776,34.70583500255422,16.885714293220435,55.70422535211268,44.29577464788732
249,73,41,32,20,53,159,169,22.986301369863014,34.32491850723097,18.798369164001908,56.0,44.0
250,70,40,30,19,51,160,171,23.085714285714285,32.641995714004246,17.343718571710042,54.642857142857146,45.357142857142854
251,66,40,26,19,47,160,175,23.62121212121212,28.594794312690052,22.04156932367359,54.27272727272727,45.72727272727273
252,64,40,24,17,47,160,180,22.890625,24.304361502114737,29.320644122580003,57.21875,42.78125
253,62,38,24,18,44,161,182,22.258064516129032,22.791013607907626,30.43484309167259,57.17741935483871,42.82258064516129
254,64,37,27,17,47,162,182,21.546875,24.718387115266086,30.234737884733917,56.390625,43.609375
255,64,36,28,18,46,163,182,21.6875,25.29284473252582,28.254030267474185,57.53125,42.46875
256,64,38,26,18,46,163,183,22.0625,24.521052635780116,29.041447364219884,56.71875,43.28125
257,64,37,27,17,47,164,183,22.21875,24.398760573136904,28.507489426863096,57.703125,42.296875
258,64,40,24,17,47,164,183,23.21875,25.922623017630087,26.202376982369913,57.703125,42.296875
259,65,42,23,17,48,164,184,23.276923076923076,26.8452193323817,27.524011436849065,58.46153846153846,41.53846153846154
260,66,45,21,17,49,164,184,23.924242424242426,29.194774619996302,24.487043561821878,57.75757575757576,42.24242424242424
261,68,47,21,16,52,164,185,23.470588235294116,29.510251990767433,24.195630362173745,57.69117647058823,42.30882352941177
262,66,44,22,14,52,165,187,23.09090909090909,29.719441384179767,22.29571013097175,58.45454545454545,41.54545454545455
263,66,44,22,13,53,166,187,23.257575757575758,32.51626333922107,19.13525181229408,58.72727272727273,41.27272727272727
264,66,44,22,13,53,166,188,24.0,32.88925043426065,17.810002811409014,57.84848484848485,42.15151515151515
265,62,41,21,12,50,168,190,23.983870967741936,32.743726983428395,16.305721411852197,57.45161290322581,42.54838709677419
266,61,42,19,14,47,168,191,25.098360655737704,31.981316362516985,17.77278199813875,57.22950819672131,42.77049180327869
267,59,40,19,14,45,168,194,25.694915254237287,30.44171177997984,21.780434798330646,58.16949152542373,41.83050847457627
268,56,41,15,13,43,169,196,26.178571428571427,28.070587378155697,21.67948188089709,57.982142857142854,42.017857142857146
269,55,37,18,14,41,170,199,25.745454545454546,24.966893148048275,28.72110685195172,56.70909090909091,43.29090909090909
270,55,38,17,14,41,171,199,25.745454545454546,24.109316933647257,27.772341605621598,56.67272727272727,43.32727272727273
271,55,39,16,16,39,171,199,26.745454545454546,23.325054139033945,27.838582224602415,56.67272727272727,43.32727272727273
272,56,40,16,16,40,171,199,27.267857142857142,24.69535379772893,27.518931916556785,57.089285714285715,42.910714285714285
273,54,38,16,15,39,172,200,27.814814814814813,23.09780475590154,25.867049382503783,55.888888888888886,44.111111111111114
274,54,38,16,14,40,173,200,27.85185185185185,23.640690628495143,25.303753815949303,56.370370370370374,43.629629629629626
275,54,38,16,14,40,174,201,27.59259259259259,22.48328630738234,26.59582031624276,56.333333333333336,43.666666666666664
276,53,36,17,14,39,175,202,27.67924528301887,21.856873495227035,27.705605524818104,57.0,43.0
277,55,40,15,14,41,175,202,27.672727272727272,20.765837838829828,29.815980342988354,57.345454545454544,42.654545454545456
278,57,40,17,16,41,176,202,26.789473684210527,21.79761736125632,30.103281097982578,55.56140350877193,44.43859649122807
279,61,41,20,18,43,176,202,26.0327868852459,23.978366545030205,30.30032197955996,54.0,46.0
280,66,41,25,18,48,176,202,25.060606060606062,26.157364132953035,28.82748435189545,52.86363636363637,47.13636363636363
281,68,42,26,18,50,176,202,25.323529411764707,27.513817847147333,25.324417446970315,52.911764705882355,47.088235294117645
282,66,39,27,15,51,178,203,24.848484848484848,27.763076280013987,23.389990108279985,51.81818181818182,48.18181818181818
283,65,37,28,14,51,179,204,24.6,27.268679675877145,25.85440870261884,50.09230769230769,49.90769230769231
284,63,36,27,17,46,179,206,24.80952380952381,25.44942580788603,27.78866943020921,50.07936507936508,49.92063492063492
285,64,37,27,18,46,180,207,24.234375,26.498765754576713,27.350355835342725,48.53125,51.46875
286,65,37,28,18,47,180,207,24.861538461538462,27.495501296454314,25.750652549699534,48.01538461538462,51.98461538461538
287,64,34,30,17,47,182,209,23.03125,25.01353683388273,29.2648480528304,46.71875,53.28125
288,65,35,30,17,48,182,209,23.676923076923078,25.46960174594935,27.961167484819878,47.06153846153846,52.93846153846154
289,64,33,31,16,48,183,210,23.4375,25.37686429407162,27.35751070592838,46.140625,53.859375
290,64,33,31,15,49,183,211,23.640625,24.878108255228017,27.559391744771986,46.484375,53.515625
291,65,34,31,15,50,184,211,23.415384615384614,26.440631204201953,25.790138026567277,46.15384615384615,53.84615384615385
292,64,33,31,14,50,186,211,23.109375,28.23742725632775,22.76181054475139,46.6875,53.3125
293,65,33,32,14,51,186,211,23.753846153846155,29.20436069595469,21.76487007327608,46.12307692307692,53.87692307692308
294,63,38,25,14,49,186,213,25.0,28.033729653807715,20.33690489805422,47.333333333333336,52.666666666666664
295,58,33,25,13,45,191,215,23.155172413793103,25.983516237763283,22.309737281995908,47.91379310344828,52.08620689655172
296,56,35,21,13,43,193,215,23.142857142857142,23.94709702134781,23.98038811238525,48.285714285714285,51.714285714285715
297,56,33,23,14,42,194,217,22.589285714285715,21.56918371078687,30.698671294956533,48.464285714285715,51.535714285714285
298,56,34,22,14,42,195,218,22.339285714285715,19.813884168194644,30.28563925783414,48.05357142857143,51.94642857142857
299,55,32,23,15,40,197,218,21.763636363636362,18.476885429098232,29.019127955205693,47.89090909090909,52.10909090909091
300,56,33,23,15,41,197,218,22.375,18.91699254965834,29.725864593198803,47.089285714285715,52.910714285714285
301,61,34,27,21,40,198,218,20.491803278688526,21.166094087756473,33.93226656798123,48.721311475409834,51.278688524590166
302,62,35,27,20,42,199,218,20.274193548387096,20.33233622345363,30.95798635719153,49.58064516129032,50.41935483870968
303,66,36,30,20,46,199,218,20.045454545454547,22.603072603455825,30.472684972301753,49.42424242424242,50.57575757575758
304,69,38,31,20,49,199,218,20.17391304347826,23.507914074187724,27.55005694030503,50.7536231884058,49.2463768115942
305,71,38,33,19,52,200,218,19.87323943661972,24.754910205031056,26.808470076659088,49.45070422535211,50.54929577464789
306,74,39,35,19,55,200,218,20.06756756756757,26.12064727932508,26.37935272067492,49.71621621621622,50.28378378378378
307,74,42,32,19,55,200,218,21.06756756756757,26.309816628181473,24.1631563447915,49.71621621621622,50.28378378378378
308,76,42,34,21,55,200,218,21.513157894736842,29.107546732747945,23.392453267252055,49.21052631578947,50.78947368421053
309,76,42,34,19,57,201,219,21.223684210526315,29.328644265112505,22.573554073728175,47.828947368421055,52.171052631578945
310,77,42,35,21,56,201,219,21.948051948051948,29.770374748709933,21.91793693960176,47.22077922077922,52.77922077922078
311,75,41,34,20,55,202,221,21.64,27.4436195019181,24.638180802902585,47.53333333333333,52.46666666666667
312,75,40,35,24,51,202,222,21.946666666666665,26.20107162044771,26.71892837955229,47.333333333333336,52.666666666666664
313,70,37,33,21,49,204,225,21.2,20.998033404628696,32.76312602418619,47.51428571428571,52.48571428571429
314,74,40,34,21,53,204,225,21.054054054054053,24.262442515082157,31.98080072816109,48.7972972972973,51.2027027027027
315,77,41,36,21,56,204,225,21.233766233766232,26.067622751442,29.737572053752807,48.61038961038961,51.38961038961039
316,79,41,38,23,56,204,225,21.696202531645568,28.486141671048113,26.767022885913914,48.29113924050633,51.70886075949367
317,81,46,35,23,58,204,225,22.160493827160494,30.559823668446178,25.02042324513407,48.160493827160494,51.839506172839506
318,82,50,32,25,57,204,226,22.695121951219512,32.45516887285215,23.227757956416145,48.68292682926829,51.31707317073171
319,82,50,32,24,58,205,227,22.353658536585368,32.33461456272752,23.360781421107866,49.609756097560975,50.390243902439025
320,77,49,28,23,54,205,232,23.01298701298701,29.345204137490008,26.119679837364938,48.84415584415584,51.15584415584416
321,76,49,27,22,54,205,234,23.513157894736842,28.949862035586527,27.879085332834524,48.9078947368421,51.0921052631579
322,75,50,25,20,55,206,235,23.533333333333335,28.158608737005828,27.0947245963275,48.28,51.72
323,77,49,28,20,57,207,236,23.0,29.593907192143387,26.94066877807756,48.44155844155844,51.55844155844156
324,76,48,28,20,56,207,239,23.605263157894736,27.25738509557744,28.25577279915941,49.03947368421053,50.96052631578947
325,76,49,27,19,57,208,239,23.855263157894736,28.107144410362945,25.600656248365876,49.75,50.25
326,79,50,29,19,60,208,239,23.949367088607595,29.454153818198325,26.67242846028269,49.30379746835443,50.69620253164557
327,79,51,28,19,60,208,239,24.949367088607595,30.43006340358555,23.797784697680274,49.30379746835443,50.69620253164557
328,80,52,28,19,61,208,239,25.6375,31.48029722679537,23.78220277320463,49.2625,50.7375
329,78,51,27,21,57,208,242,26.5,29.22311112281319,27.30094452505211,48.42307692307692,51.57692307692308
330,75,51,24,21,54,208,245,27.813333333333333,26.872530205571163,30.29810777686274,47.78666666666667,52.21333333333333
331,74,51,23,23,51,209,245,28.486486486486488,27.287829415051014,29.43617198339936,48.229729729729726,51.770270270270274
332,77,54,23,23,54,209,245,28.376623376623378,28.991979662121334,29.488539818398145,48.18181818181818,51.81818181818182
333,75,53,22,22,53,210,247,28.92,28.22609058385657,28.46724274947676,48.04,51.96
334,71,51,20,20,51,211,250,28.774647887323944,25.9631361495612,29.487568075790907,48.647887323943664,51.352112676056336
335,71,48,23,18,53,214,250,27.408450704225352,27.12789640088782,30.393387009095072,48.014084507042256,51.985915492957744
336,68,46,22,15,53,217,251,26.970588235294116,26.018016810940622,28.49029160573789,47.5,52.5
337,69,47,22,19,50,217,251,27.579710144927535,26.152421465561655,28.441781432989067,48.17391304347826,51.82608695652174
338,70,45,25,18,52,219,251,26.7,28.607396117820723,27.22557952690744,50.67142857142857,49.32857142857143
339,69,47,22,17,52,220,251,27.26086956521739,29.941104565316365,23.84150413033581,50.95652173913044,49.04347826086956
340,68,48,20,17,51,220,253,28.102941176470587,29.57588938530627,24.88922386906041,51.1764705882353,48.8235294117647
341,66,45,21,17,49,221,257,28.060606060606062,26.508161546791044,29.506861346630114,50.56060606060606,49.43939393939394
342,66,46,20,16,50,222,258,27.984848484848484,25.72340760233364,30.049319670393636,50.09090909090909,49.90909090909091
343,67,43,24,20,47,224,259,26.64179104477612,25.60380198600904,31.530597981637563,51.32835820895522,48.67164179104478
344,68,42,26,20,48,225,260,26.13235294117647,26.11096968937236,31.35961854592174,50.88235294117647,49.11764705882353
345,67,39,28,18,49,228,261,24.507462686567163,26.403742067296285,30.073869873002224,50.1044776119403,49.8955223880597
346,67,37,30,19,48,229,262,24.074626865671643,27.30809844768357,28.787315610200494,49.08955223880597,50.91044776119403
347,65,33,32,17,48,232,263,23.03076923076923,26.791132576369243,28.24097468315026,50.10769230769231,49.89230769230769
348,66,35,31,17,49,232,263,23.681818181818183,28.694291506218576,25.442072130145057,50.25757575757576,49.74242424242424
349,66,34,32,16,50,232,265,23.681818181818183,29.057550922664714,27.18487331975953,52.06060606060606,47.93939393939394
350,67,33,34,16,51,233,265,23.52238805970149,30.320900060853877,25.85820441675807,50.95522388059702,49.04477611940298
351,65,33,32,17,48,233,268,23.907692307692308,27.85990657233282,28.186247273821024,52.276923076923076,47.723076923076924
352,66,35,31,17,49,233,268,24.545454545454547,30.021150451328637,25.433395003216823,52.75757575757576,47.24242424242424
353,65,32,33,16,49,235,269,23.523076923076925,28.174204620874217,26.935029119090498,52.738461538461536,47.261538461538464
354,64,32,32,18,46,235,271,23.828125,26.2880948060863,29.9619051939137,51.984375,48.015625
355,62,31,31,19,43,236,273,23.629032258064516,24.32078084176064,31.195348190497423,51.16129032258065,48.83870967741935
356,63,29,34,18,45,238,273,22.49206349206349,25.987936817645544,30.64698381727509,50.698412698412696,49.301587301587304
357,65,33,32,18,47,238,273,22.8,26.165943299962134,29.08021054619171,50.815384615384616,49.184615384615384
358,62,31,31,16,46,241,274,21.967741935483872,22.68406530383264,31.6011564477464,51.83870967741935,48.16129032258065
359,63,33,30,15,48,242,274,21.6984126984127,23.513505770053992,31.19181849291421,51.96825396825397,48.03174603174603
360,66,31,35,15,51,243,275,20.12121212121212,24.03610588456537,32.78207593361645,53.71212121212121,46.28787878787879
361,68,35,33,15,53,243,275,20.529411764705884,25.48229583642676,27.679468869455594,53.838235294117645,46.161764705882355
362,66,38,28,15,51,245,275,20.484848484848484,25.567895535765917,24.659377191506806,54.28787878787879,45.71212121212121
363,66,38,28,14,52,246,275,20.71212121212121,27.075756980247515,24.800555628196285,54.92424242424242,45.07575757575758
364,66,38,28,14,52,246,277,21.106060606060606,25.421600742352922,27.881429560677383,54.93939393939394,45.06060606060606
365,68,40,28,14,54,246,277,21.485294117647058,26.71376894778528,26.124466346332365,54.970588235294116,45.029411764705884
366,67,40,27,18,49,246,278,22.492537313432837,26.636404067036196,24.677028768784698,55.507462686567166,44.492537313432834
367,69,41,28,18,51,246,279,22.55072463768116,26.76704847935673,27.827154419193995,54.44927536231884,45.55072463768116
368,67,39,28,18,49,247,281,22.80597014925373,24.92401596769949,27.79483164277116,55.02985074626866,44.97014925373134
369,67,39,28,18,49,248,281,22.80597014925373,25.50831715118571,27.20301104320397,54.134328358208954,45.865671641791046
370,68,38,30,17,51,249,282,22.38235294117647,25.582993362990358,29.534653695833168,54.60294117647059,45.39705882352941
371,65,36,29,15,50,251,284,22.16923076923077,22.700557453716687,30.315653469677144,52.676923076923075,47.323076923076925
372,65,37,28,14,51,252,284,22.369230769230768,23.570484011553358,29.337208296138947,52.95384615384615,47.04615384615385
373,65,39,26,15,50,253,284,22.53846153846154,23.90842011643154,28.783887575876157,52.292307692307695,47.707692307692305
374,68,40,28,15,53,253,284,22.544117647058822,24.54650720687474,28.497610440184083,52.48529411764706,47.51470588235294
375,69,41,28,16,53,254,284,22.47826086956522,25.599698879876666,26.031331598909773,51.927536231884055,48.072463768115945
376,70,45,25,20,50,254,284,23.15714285714286,27.47604452136457,24.02395547863543,51.68571428571428,48.31428571428572
377,69,46,23,19,50,254,286,23.304347826086957,24.49817180535367,27.93661080334198,53.072463768115945,46.927536231884055
378,70,45,25,18,52,255,286,23.214285714285715,25.371786289576516,27.328213710423487,53.05714285714286,46.94285714285714
379,70,46,24,18,52,255,286,24.214285714285715,26.292829716149427,25.121455998136287,53.05714285714286,46.94285714285714
380,71,47,24,17,54,255,287,24.225352112676056,25.402668004471323,27.45648692510614,51.70422535211268,48.29577464788732
381,71,48,23,16,55,256,287,24.507042253521128,26.492513195085163,24.56670405950486,51.38028169014085,48.61971830985915
382,71,47,24,16,55,256,288,25.239436619718308,27.119404392129564,25.190454762800016,50.42253521126761,49.57746478873239
383,68,47,21,15,53,258,289,25.352941176470587,26.192578892760288,23.77800934253383,51.11764705882353,48.88235294117647
384,68,45,23,15,53,259,291,24.897058823529413,23.564964602679968,30.08209422084944,50.838235294117645,49.161764705882355
385,70,45,25,15,55,259,291,25.185714285714287,24.51303062086949,28.21554080770194,49.77142857142857,50.22857142857143
386,72,47,25,15,57,259,291,25.48611111111111,26.097445026210877,26.41644386267801,49.75,50.25
387,74,49,25,15,59,259,292,25.472972972972972,26.78425080574491,25.13466811317401,49.2027027027027,50.7972972972973
388,75,48,27,14,61,261,292,24.746666666666666,28.058999250886924,24.13897324430453,50.48,49.52
389,74,47,27,14,60,262,293,25.094594594594593,27.437697836791404,23.575815676722108,49.95945945945946,50.04054054054054
390,75,47,28,13,62,263,293,25.013333333333332,28.96161169560297,22.891721637730363,49.96,50.04
391,73,48,25,15,58,263,296,25.45205479452055,28.117476210056164,23.23868817350548,49.47945205479452,50.52054794520548
392,70,46,24,16,54,264,298,25.885714285714286,26.290299347220547,25.18112922420802,48.65714285714286,51.34285714285714
393,72,47,25,16,56,264,298,26.166666666666668,26.906662301187588,27.06555992103463,48.80555555555556,51.19444444444444
394,72,45,27,15,57,266,299,25.34722222222222,26.099558068257178,29.389858591815887,49.27777777777778,50.72222222222222
395,73,44,29,14,59,266,301,24.65753424657534,25.279783397269,30.340084087009274,49.71232876712329,50.28767123287671
396,72,44,28,14,58,266,303,24.97222222222222,23.733174491574776,30.33626995286967,49.02777777777778,50.97222222222222
397,70,42,28,14,56,268,304,24.414285714285715,24.19858881714372,27.97840264680479,49.542857142857144,50.457142857142856
398,68,40,28,12,56,270,305,24.13235294117647,22.692399499431406,29.7138421901324,49.63235294117647,50.36764705882353
399,68,38,30,12,56,270,307,24.470588235294116,20.885632857958797,32.79083773027649,49.720588235294116,50.279411764705884
400,69,40,29,14,55,270,307,25.115942028985508,21.366804925499462,31.99551391508024,50.15942028985507,49.84057971014493
401,70,41,29,16,54,271,307,24.97142857142857,23.235474957827922,29.335953613600648,49.9,50.1
402,71,43,28,16,55,271,307,25.619718309859156,25.151077527159295,26.454556275657612,50.478873239436616,49.521126760563384
403,71,45,26,16,55,272,308,25.492957746478872,24.83963108659521,26.949101307770984,49.95774647887324,50.04225352112676
404,71,43,28,15,56,274,309,24.225352112676056,24.71431333058757,27.539341493232786,48.943661971830984,51.056338028169016
405,72,46,26,15,57,274,309,24.88888888888889,25.39281426944264,25.63496350833514,48.513888888888886,51.486111111111114
406,74,47,27,15,59,274,310,24.905405405405407,25.894831128337902,26.67078191135013,48.13513513513514,51.86486486486486
407,75,47,28,16,59,275,310,24.866666666666667,25.67226378588931,25.581069547444024,47.973333333333336,52.026666666666664
408,75,46,29,16,59,276,310,25.173333333333332,25.439383604033008,25.173949729300325,47.42666666666667,52.57333333333333
409,77,47,30,18,59,276,310,25.51948051948052,25.644124671976602,24.680550652698727,46.467532467532465,53.532467532467535
410,73,43,30,18,55,280,311,24.684931506849313,25.085264368145204,23.216105494868497,45.76712328767123,54.23287671232877
411,73,48,25,17,56,281,311,24.986301369863014,24.61876929253211,23.087338501288386,46.19178082191781,53.80821917808219
412,74,48,26,16,58,282,311,24.945945945945947,26.80536934931969,22.559495515545176,46.2027027027027,53.7972972972973
413,73,46,27,15,58,283,313,24.84931506849315,24.97976534135756,24.91691375382466,45.64383561643836,54.35616438356164
414,73,46,27,15,58,283,314,25.52054794520548,25.402068434743136,23.515739784434942,46.02739726027397,53.97260273972603
415,74,47,27,15,59,284,314,25.16216216216216,25.819498662416066,22.42374458082718,46.310810810810814,53.689189189189186
416,72,45,27,14,58,287,314,24.65277777777778,25.287344400314726,24.045988933018606,44.916666666666664,55.083333333333336
417,70,43,27,14,56,290,314,23.9,25.60384737700557,22.867581194422996,44.628571428571426,55.371428571428574
418,69,43,26,14,55,291,314,24.391304347826086,25.898539822178446,21.21740220680706,44.492753623188406,55.507246376811594
419,67,43,24,12,55,293,315,23.940298507462686,23.2818769690818,24.255436463754027,44.0,56.0
420,68,45,23,12,56,293,315,24.58823529411765,23.031863642979715,25.041665768784995,44.220588235294116,55.779411764705884
421,67,46,21,12,55,293,316,25.597014925373134,21.11316379850168,26.40922426119981,43.80597014925373,56.19402985074627
422,65,44,21,13,52,294,318,25.353846153846153,19.122502153473143,28.680163595034937,43.10769230769231,56.89230769230769
423,67,46,21,15,52,294,318,25.597014925373134,20.06705767810134,28.500106501003135,43.16417910447761,56.83582089552239
424,69,48,21,15,54,294,318,25.855072463768117,20.9191763060455,27.138794708447254,44.08695652173913,55.91304347826087
425,69,48,21,15,54,295,318,26.07246376811594,21.26633709172454,26.313373053202994,44.594202898550726,55.405797101449274
426,70,49,21,16,54,296,318,25.928571428571427,21.570140537098986,26.472716605758155,45.7,54.3
427,72,50,22,16,56,296,318,26.208333333333332,22.647449880919755,26.25532789685802,46.125,53.875
428,72,51,21,14,58,298,318,25.73611111111111,24.689994630315503,24.04611648079561,46.833333333333336,53.166666666666664
429,71,52,19,13,58,299,318,26.08450704225352,25.521494543814757,22.651377869750874,46.563380281690144,53.436619718309856
430,73,52,21,13,60,300,318,25.616438356164384,26.802427496170587,23.80031222985681,45.534246575342465,54.465753424657535
431,72,52,20,14,58,301,319,25.875,26.240500150093123,22.953944294351324,45.72222222222222,54.27777777777778
432,74,52,22,14,60,301,320,25.783783783783782,24.381134956138872,25.528156861913008,45.148648648648646,54.851351351351354
433,75,51,24,13,62,302,321,25.373333333333335,23.259973834626905,26.713359498706424,45.82666666666667,54.17333333333333
434,74,50,24,12,62,303,321,26.013513513513512,23.655283804631047,23.85822970888247,46.351351351351354,53.648648648648646
435,74,49,25,14,60,305,321,25.58108108108108,24.31932897168755,23.357025406343574,46.78378378378378,53.21621621621622
436,73,49,24,14,59,306,321,26.232876712328768,24.535636139232416,22.328829039456576,47.28767123287671,52.71232876712329
437,73,48,25,14,59,306,322,26.876712328767123,24.42638334327482,24.066767341656686,47.80821917808219,52.19178082191781
438,71,47,24,13,58,307,323,27.492957746478872,23.628800914113523,24.685446114643955,48.394366197183096,51.605633802816904
439,68,44,24,12,56,310,324,26.808823529411764,20.842728401481214,27.58959189948545,49.161764705882355,50.838235294117645
440,66,45,21,11,55,311,325,27.424242424242426,18.64123977822903,29.313305676316425,49.53030303030303,50.46969696969697
441,65,45,20,10,55,312,325,28.046153846153846,18.15620768029912,29.166869242777807,49.276923076923076,50.723076923076924
442,65,46,19,11,54,313,325,28.16923076923077,18.168518747946447,28.899609650274133,49.46153846153846,50.53846153846154
443,64,46,18,10,54,314,325,28.765625,18.735648841030375,28.123726158969625,49.40625,50.59375
444,63,47,16,9,54,315,325,29.238095238095237,17.539340181783604,28.67873182832869,49.714285714285715,50.285714285714285
445,62,47,15,9,53,316,325,29.806451612903224,17.229220997157743,28.355481934929678,50.04838709677419,49.95161290322581
446,62,47,15,10,52,318,325,29.129032258064516,18.000358931792384,28.213269375986265,51.274193548387096,48.725806451612904
447,61,48,13,10,51,319,325,29.75409836065574,18.07599554375015,27.153512652971155,51.14754098360656,48.85245901639344
448,61,48,13,10,51,321,325,28.950819672131146,17.88369368275507,27.788437464785915,50.60655737704918,49.39344262295082
449,62,50,12,10,52,321,325,29.483870967741936,18.842212771374978,26.528754970560502,50.20967741935484,49.79032258064516
450,61,49,12,8,53,323,325,29.19672131147541,18.789114374558906,25.42537353174977,49.80327868852459,50.19672131147541
451,62,52,10,8,54,323,325,29.725806451612904,20.46104126710461,23.990571636121203,49.46774193548387,50.53225806451613
452,62,51,11,9,53,324,325,29.677419354838708,20.998041288194052,22.679378066644656,48.46774193548387,51.53225806451613
453,62,52,10,9,53,324,325,30.677419354838708,19.889773359862925,23.62635567239514,48.46774193548387,51.53225806451613
454,61,51,10,9,52,324,326,31.639344262295083,18.29704270141839,25.094194814970855,48.16393442622951,51.83606557377049
455,59,50,9,7,52,326,326,31.89830508474576,17.67831162358952,25.592874817088447,47.45762711864407,52.54237288135593
456,58,49,9,7,51,327,326,32.51724137931034,18.437354151617047,24.70057688286571,47.98275862068966,52.01724137931034
457,58,49,9,7,51,327,326,33.51724137931034,17.78480423990214,25.870368173890963,47.98275862068966,52.01724137931034
458,57,48,9,7,50,328,326,34.05263157894737,17.046684318884875,26.602438488132673,47.50877192982456,52.49122807017544
459,53,44,9,6,47,332,326,33.320754716981135,16.493913848507198,24.400661123522806,47.113207547169814,52.886792452830186
460,53,44,9,6,47,333,326,33.24528301886792,16.885743791125066,25.718029793780595,45.886792452830186,54.113207547169814
461,54,44,10,6,48,333,326,33.629629629629626,15.252578289703271,27.6177920806671,45.407407407407405,54.592592592592595
462,51,43,8,6,45,336,326,33.411764705882355,14.27461052433417,27.803820848214844,47.372549019607845,52.627450980392155
463,51,42,9,6,45,337,326,33.333333333333336,14.232615616258569,28.87394772164861,46.84313725490196,53.15686274509804
464,49,42,7,6,43,339,326,33.30612244897959,13.50218172460728,27.536527592286088,47.59183673469388,52.40816326530612
465,47,41,6,6,41,341,326,33.42553191489362,12.188178378848452,27.83309821689623,46.87234042553192,53.12765957446808
466,47,41,6,7,40,342,326,33.1063829787234,12.26972239291278,30.009045315966286,47.765957446808514,52.234042553191486
467,43,37,6,7,36,346,326,32.30232558139535,10.884583462618496,30.894765510172373,46.23255813953488,53.76744186046512
468,42,38,4,6,36,347,326,32.523809523809526,9.761904761904763,33.95238095238095,46.54761904761905,53.45238095238095
469,42,38,4,6,36,347,326,33.523809523809526,10.0,33.95238095238095,46.54761904761905,53.45238095238095
470,42,38,4,8,34,347,326,34.523809523809526,10.081342478283098,33.87103847409786,46.54761904761905,53.45238095238095
471,42,37,5,7,35,348,326,34.285714285714285,10.714285714285714,33.19047619047619,45.38095238095238,54.61904761904762
472,41,36,5,6,35,349,326,34.829268292682926,9.75609756097561,31.853658536585368,46.146341463414636,53.853658536585364
473,41,36,5,6,35,349,326,35.829268292682926,10.0,31.609756097560975,46.146341463414636,53.853658536585364
474,40,35,5,6,34,350,326,36.35,9.75,30.55,46.75,53.25
475,38,33,5,6,32,352,326,36.473684210526315,9.473684210526315,30.605263157894736,46.973684210526315,53.026315789473685
476,37,33,4,6,31,353,326,37.054054054054056,9.72972972972973,31.675675675675677,46.45945945945946,53.54054054054054
477,38,34,4,6,32,353,326,37.078947368421055,11.052631578947368,32.60526315789474,47.55263157894737,52.44736842105263
478,37,33,4,8,29,354,326,37.648648648648646,9.72972972972973,32.45945945945946,47.2972972972973,52.7027027027027
479,37,32,5,8,29,355,326,37.270270270270274,10.81081081081081,33.108108108108105,46.4054054054054,53.5945945945946
480,37,32,5,8,29,356,326,36.78378378378378,10.81081081081081,32.08108108108108,47.513513513513516,52.486486486486484
481,33,28,5,7,26,360,326,35.93939393939394,9.090909090909092,32.515151515151516,46.121212121212125,53.878787878787875
482,33,27,6,8,25,361,326,35.27272727272727,10.909090909090908,32.60606060606061,47.0,53.0
483,34,26,8,8,26,363,326,31.91176470588235,12.941176470588236,30.11764705882353,46.3235294117647,53.6764705882353
484,35,25,10,7,28,364,326,30.457142857142856,12.0,28.942857142857143,46.42857142857143,53.57142857142857
485,35,25,10,7,28,364,326,31.457142857142856,10.0,28.085714285714285,46.42857142857143,53.57142857142857
486,35,25,10,7,28,364,326,32.457142857142856,10.0,28.085714285714285,46.42857142857143,53.57142857142857
487,33,22,11,6,27,367,326,30.21212121212121,10.303030303030303,30.606060606060606,44.666666666666664,55.333333333333336
488,35,23,12,6,29,367,326,29.485714285714284,12.285714285714286,33.05714285714286,44.8,55.2
489,34,21,13,5,29,369,326,28.147058823529413,10.588235294117647,32.44117647058823,45.85294117647059,54.14705882352941
490,35,21,14,5,30,369,326,28.34285714285714,11.142857142857142,33.51428571428571,46.2,53.8
491,36,20,16,4,32,370,326,26.944444444444443,11.944444444444445,32.77777777777778,47.77777777777778,52.22222222222222
492,38,20,18,6,32,370,326,26.526315789473685,12.105263157894736,30.81578947368421,50.31578947368421,49.68421052631579
493,38,20,18,6,32,371,326,25.92105263157895,10.789473684210526,32.078947368421055,49.89473684210526,50.10526315789474
494,38,19,19,5,33,372,326,25.342105263157894,10.789473684210526,32.44736842105263,51.18421052631579,48.81578947368421
495,38,18,20,5,33,373,326,24.736842105263158,10.789473684210526,34.05263157894737,49.973684210526315,50.026315789473685
496,36,17,19,4,32,375,326,24.083333333333332,9.444444444444445,35.361111111111114,50.55555555555556,49.44444444444444
497,38,17,21,4,34,375,326,23.81578947368421,12.105263157894736,35.63157894736842,49.36842105263158,50.63157894736842
498,38,18,20,6,32,375,326,24.81578947368421,10.0,35.10526315789474,49.36842105263158,50.63157894736842
499,38,20,18,10,28,376,326,24.07894736842105,10.789473684210526,36.81578947368421,48.05263157894737,51.94736842105263
500,36,20,16,8,28,379,326,21.63888888888889,10.277777777777779,39.19444444444444,45.166666666666664,54.833333333333336
501,38,20,18,8,30,379,326,21.5,12.105263157894736,38.13157894736842,46.39473684210526,53.60526315789474
502,39,19,20,7,32,380,326,20.53846153846154,12.460145986469032,38.0783155519925,47.51282051282051,52.48717948717949
503,41,19,22,11,30,380,326,20.536585365853657,12.933165098748423,38.57903002320279,48.1219512195122,51.8780487804878
504,43,21,22,11,32,381,326,19.325581395348838,14.085023450846382,41.51962771194432,50.06976744186046,49.93023255813954
505,43,22,21,11,32,381,326,20.325581395348838,12.419398161178405,39.69688090858904,50.06976744186046,49.93023255813954
506,40,19,21,10,30,384,326,18.725,10.901604567948723,40.74839543205128,52.15,47.85
507,42,21,21,12,30,384,326,18.833333333333332,13.155797629939663,42.606107131965096,52.95238095238095,47.04761904761905
508,44,23,21,12,32,384,326,18.977272727272727,13.736894640749354,41.30855990470519,54.79545454545455,45.20454545454545
509,47,22,25,12,35,385,326,17.48936170212766,15.408230396650652,39.74070577356211,52.97872340425532,47.02127659574468
510,52,25,27,14,38,385,326,16.807692307692307,17.068935938895077,38.33491021495108,53.98076923076923,46.01923076923077
511,55,25,30,14,41,386,326,15.945454545454545,19.249629821846025,36.29582472360852,55.236363636363635,44.763636363636365
512,55,24,31,13,42,387,326,16.0,19.669648644523747,32.90459947806276,56.67272727272727,43.32727272727273
513,57,25,32,13,44,387,326,16.43859649122807,20.569713855788912,33.04432123193038,57.63157894736842,42.36842105263158
514,58,26,32,15,43,387,326,17.155172413793103,20.81723873163672,32.66551988905294,57.672413793103445,42.327586206896555
515,59,27,32,15,44,387,326,17.864406779661017,21.02866332070781,32.07303159454643,58.0,42.0
516,61,28,33,15,46,387,326,18.278688524590162,22.34516516584762,31.589261063660572,57.377049180327866,42.622950819672134
517,59,27,32,14,45,389,327,17.694915254237287,21.633036671677374,30.977132819848052,57.52542372881356,42.47457627118644
518,63,28,35,14,49,389,328,17.142857142857142,20.657281456609187,36.00938521005748,54.698412698412696,45.301587301587304
519,66,30,36,14,52,389,328,17.363636363636363,22.118187764388157,32.76060011439972,53.93939393939394,46.06060606060606
520,68,33,35,16,52,389,328,17.852941176470587,23.294035835250455,31.000081811808368,53.89705882352941,46.10294117647059
521,69,33,36,16,53,389,328,18.594202898550726,24.061666799395216,29.778912910749714,53.98550724637681,46.01449275362319
522,71,33,38,16,55,389,328,19.070422535211268,25.31245449751049,29.800221558827538,53.61971830985915,46.38028169014085
523,73,35,38,22,51,389,328,19.54794520547945,25.84798185274336,29.357497599311433,52.83561643835616,47.16438356164384
524,75,37,38,22,53,389,328,20.026666666666667,27.731443264366067,27.50855673563393,52.72,47.28
525,74,38,36,22,52,389,329,21.04054054054054,27.612457386379614,26.171326397404172,52.4054054054054,47.5945945945946
526,75,43,32,22,53,389,329,21.76,29.026357277542253,24.77364272245775,52.18666666666667,47.81333333333333
527,74,46,28,22,52,389,332,22.18918918918919,26.57964286680231,26.912754386968672,51.17567567567568,48.82432432432432
528,75,47,28,22,53,389,332,22.893333333333334,29.133285113378363,24.120048219954974,51.626666666666665,48.373333333333335
529,74,45,29,21,53,390,335,22.68918918918919,27.786640847656237,25.55367892685238,50.12162162162162,49.87837837837838
530,73,44,29,21,52,390,337,23.410958904109588,26.911560913360184,25.367716202891113,51.397260273972606,48.602739726027394
531,73,43,30,21,52,390,339,23.84931506849315,25.192125932715207,28.06040962495001,50.821917808219176,49.178082191780824
532,73,42,31,20,53,391,341,23.410958904109588,25.087196367994377,31.488146097759042,49.68493150684932,50.31506849315068
533,72,41,31,24,48,391,343,24.11111111111111,23.45580920897437,32.974746346581185,48.80555555555556,51.19444444444444
534,71,43,28,25,46,393,343,24.0,23.94982439782127,32.36003475710831,47.57746478873239,52.42253521126761
535,73,44,29,25,48,394,343,23.643835616438356,25.491858819968765,33.384853508798365,47.61643835616438,52.38356164383562
536,72,45,27,23,49,396,343,23.458333333333332,25.403767818582704,30.805813105552772,48.31944444444444,51.68055555555556
537,73,47,26,25,48,396,343,24.136986301369863,25.058694096580723,31.612538780131608,48.64383561643836,51.35616438356164
538,75,48,27,25,50,396,344,24.12,25.067246396738323,33.33275360326167,48.6,51.4
539,73,46,27,23,50,398,345,23.931506849315067,24.507329068606914,33.50636956153007,49.054794520547944,50.945205479452056
540,76,47,29,22,54,399,345,23.30263157894737,25.973949870154012,33.394471182477574,47.61842105263158,52.38157894736842
541,74,44,30,20,54,401,346,23.14864864864865,24.791112671366932,31.271420833649323,47.270270270270274,52.729729729729726
542,76,45,31,20,56,401,346,23.539473684210527,27.164048270801143,28.625425413409385,47.026315789473685,52.973684210526315
543,77,46,31,19,58,402,346,23.467532467532468,30.985789757021205,25.01421024297879,46.41558441558441,53.58441558441559
544,77,44,33,21,56,404,347,23.025974025974026,32.808152135514476,23.854185526823187,47.701298701298704,52.298701298701296
545,78,49,29,21,57,404,347,23.73076923076923,35.063059277579036,21.11642790190814,47.1025641025641,52.8974358974359
546,73,45,28,17,56,406,350,23.506849315068493,33.206189858328194,22.657229984277556,45.863013698630134,54.136986301369866
547,72,46,26,17,55,406,351,24.444444444444443,33.33991816652085,23.60452627792359,46.30555555555556,53.69444444444444
548,69,45,24,16,53,407,354,24.405797101449274,29.290065184023987,30.057669041000235,47.14492753623188,52.85507246376812
549,67,43,24,19,48,409,356,24.313432835820894,25.235155145420503,35.91592899296696,46.014925373134325,53.985074626865675
550,67,45,22,19,48,409,357,25.208955223880597,24.018187287636987,35.93703659296003,46.44776119402985,53.55223880597015
551,68,46,22,22,46,409,358,25.0,23.042405846394868,36.85465297713455,47.0735294117647,52.9264705882353
552,70,48,22,22,48,409,358,25.285714285714285,24.655664010648913,36.08719313220822,47.24285714285714,52.75714285714286
553,72,49,23,22,50,409,358,25.583333333333332,26.45302323573853,33.67197676426147,47.541666666666664,52.458333333333336
554,73,48,25,21,52,411,358,24.80821917808219,29.04218395536122,31.238834635274568,47.75342465753425,52.24657534246575
555,74,49,25,21,53,412,358,24.743243243243242,30.34972918815987,29.737412953420566,47.4054054054054,52.5945945945946
556,69,48,21,19,50,414,361,24.695652173913043,27.42814232132116,31.905191012012168,47.44927536231884,52.55072463768116
557,68,46,22,19,49,415,363,24.426470588235293,24.9905997909163,36.129309752160474,46.529411764705884,53.470588235294116
558,69,44,25,20,49,417,363,23.536231884057973,24.201293482966776,38.79414332028562,45.44927536231884,54.55072463768116
559,73,45,28,20,53,417,364,22.835616438356166,24.558564480611356,38.56472319062152,46.58904109589041,53.41095890410959
560,73,44,29,21,52,417,365,23.054794520547944,23.902014707539774,35.90620447054242,47.38356164383562,52.61643835616438
561,75,47,28,23,52,417,365,23.44,25.460021335463423,34.793311997869914,47.50666666666667,52.49333333333333
562,77,47,30,23,54,417,365,23.83116883116883,26.903676479925565,33.109310533061446,47.922077922077925,52.077922077922075
563,78,47,31,23,55,417,365,24.525641025641026,27.928309565051013,31.61015197341053,47.55128205128205,52.44871794871795
564,78,46,32,21,57,419,365,24.141025641025642,29.497851061924564,28.722946812642874,48.1025641025641,51.8974358974359
565,80,46,34,19,61,421,365,23.075,31.930898336090195,27.01249095094719,48.1625,51.8375
566,79,44,35,18,61,422,366,23.31645569620253,31.466280745689986,25.445111659373307,47.74683544303797,52.25316455696203
567,79,46,33,20,59,422,366,24.31645569620253,32.22056017726877,24.05792083538945,47.74683544303797,52.25316455696203
568,76,43,33,18,58,425,368,23.44736842105263,31.40570934890344,27.159472479694447,48.05263157894737,51.94736842105263
569,74,43,31,18,56,426,370,23.675675675675677,30.45793688963806,27.718379367351965,47.28378378378378,52.71621621621622
570,72,41,31,18,54,428,371,23.47222222222222,28.553971942306262,29.06468040755442,48.666666666666664,51.333333333333336
571,69,41,28,18,51,428,376,23.942028985507246,23.735091648512785,32.4014038805169,49.608695652173914,50.391304347826086
572,67,40,27,18,49,428,378,25.223880597014926,22.328547070478315,32.64160218325303,50.417910447761194,49.582089552238806
573,66,38,28,17,49,430,379,24.53030303030303,20.791994098275918,33.63380835876314,51.28787878787879,48.71212121212121
574,68,40,28,16,52,431,379,24.029411764705884,22.115770425104202,32.1342295748958,50.98529411764706,49.01470588235294
575,70,42,28,16,54,431,379,24.34285714285714,23.279929528451365,30.391499042977212,51.3,48.7
576,69,45,24,15,54,432,379,24.942028985507246,23.780318598274288,28.205188648102528,51.95652173913044,48.04347826086956
577,70,47,23,15,55,432,379,25.585714285714285,23.58662165552381,29.15623548733334,51.94285714285714,48.05714285714286
578,70,49,21,15,55,433,379,25.771428571428572,25.00152236073896,27.612763353546754,51.72857142857143,48.27142857142857
579,72,49,23,15,57,433,379,26.055555555555557,25.391902414886665,28.455319807335556,51.708333333333336,48.291666666666664
580,71,48,23,15,56,435,380,25.535211267605632,25.138422456775952,29.67886862854676,52.76056338028169,47.23943661971831
581,73,51,22,15,58,435,380,25.835616438356166,26.87987311077981,27.832455656343473,53.9041095890411,46.0958904109589
582,73,51,22,14,59,436,380,26.095890410958905,27.667645758192133,25.452576729736865,53.78082191780822,46.21917808219178
583,72,50,22,14,58,436,381,27.02777777777778,26.996489116555136,26.248539628605922,53.763888888888886,46.236111111111114
584,67,46,21,13,54,437,385,27.64179104477612,23.04611531413593,31.991890134132213,53.92537313432836,46.07462686567164
585,65,46,19,14,51,439,385,27.70769230769231,22.60000092482046,32.63076830594877,54.261538461538464,45.738461538461536
586,64,45,19,14,50,440,386,27.78125,21.84051770237636,33.84698229762364,54.796875,45.203125
587,62,45,17,15,47,442,386,27.741935483870968,21.4162905153305,33.087977868450125,54.54838709677419,45.45161290322581
588,64,43,21,14,50,443,387,26.515625,21.08425383381568,35.79074616618432,54.375,45.625
589,63,43,20,13,50,444,387,27.063492063492063,20.261165835519396,32.96105638670282,54.23809523809524,45.76190476190476
590,64,47,17,15,49,444,387,27.640625,19.864577895723656,35.260422104276344,54.828125,45.171875
591,65,46,19,14,51,445,387,27.43076923076923,20.91270192897693,34.68554637189183,55.16923076923077,44.83076923076923
592,61,43,18,10,51,450,387,25.75409836065574,20.336622884543782,33.38751868381986,56.34426229508197,43.65573770491803
593,61,44,17,10,51,450,387,26.75409836065574,19.146940068645712,34.09896157069855,56.34426229508197,43.65573770491803
594,59,41,18,8,51,453,387,25.47457627118644,19.039122328294567,32.56668232576309,56.79661016949152,43.20338983050848
595,61,41,20,10,51,453,387,25.639344262295083,20.52770256121443,31.57065809452327,55.60655737704918,44.39344262295082
596,61,45,16,10,51,453,387,26.639344262295083,20.831552074809842,29.627464318632782,55.60655737704918,44.39344262295082
597,62,47,15,12,50,453,387,27.20967741935484,23.04880538155723,27.58022687650729,55.38709677419355,44.61290322580645
598,64,49,15,12,52,453,387,27.359375,23.913195969922022,26.883679030077978,54.328125,45.671875
599,65,49,16,12,53,453,387,27.93846153846154,25.4891794061407,24.04928213232084,54.676923076923075,45.323076923076925
600,67,49,18,14,53,453,387,28.104477611940297,26.20387449279889,23.691647895260814,54.71641791044776,45.28358208955224
601,70,49,21,16,54,453,387,27.9,26.66887851320206,24.80255005822651,56.02857142857143,43.97142857142857
602,71,47,24,17,54,455,387,26.535211267605632,26.79495172333721,24.711267638840543,58.070422535211264,41.929577464788736
603,72,47,25,17,55,455,388,26.625,26.502542066350323,24.941902378094124,57.47222222222222,42.52777777777778
604,71,49,22,15,56,457,388,26.535211267605632,28.708106895316106,21.277808597641638,57.478873239436616,42.521126760563384
605,72,47,25,16,56,458,389,25.86111111111111,30.698168288729207,20.093498377937465,56.708333333333336,43.291666666666664
606,74,48,26,18,56,458,389,26.16216216216216,31.919138875390157,18.405185448934166,56.932432432432435,43.067567567567565
607,73,48,25,18,55,458,391,26.356164383561644,31.582031125497302,18.568656183757753,56.794520547945204,43.205479452054796
608,73,48,25,17,56,459,391,26.65753424657534,33.71239698876106,15.917739997540313,57.602739726027394,42.397260273972606
609,70,45,25,15,55,461,392,26.8,34.05784327647551,15.713585294953061,57.457142857142856,42.542857142857144
610,66,42,24,16,50,462,396,27.136363636363637,31.635362539154137,18.15425211247348,55.46969696969697,44.53030303030303
611,63,41,22,15,48,463,399,27.19047619047619,27.449403966658313,23.91567539842105,55.57142857142857,44.42857142857143
612,59,38,21,13,46,466,401,26.050847457627118,24.769166944467063,25.49354210170547,53.86440677966102,46.13559322033898
613,61,38,23,13,48,467,401,25.327868852459016,26.96843797962896,24.22828333184645,53.49180327868852,46.50819672131148
614,60,39,21,15,45,467,402,26.2,26.36267797761968,22.720655355713653,52.85,47.15
615,60,39,21,17,43,467,403,26.566666666666666,25.027012667019264,25.459237160714206,52.766666666666666,47.233333333333334
616,59,39,20,16,43,469,403,26.06779661016949,26.489230049397865,23.67154830096257,51.86440677966102,48.13559322033898
617,57,38,19,14,43,471,404,25.333333333333332,25.716946299695113,25.388316858199627,51.73684210526316,48.26315789473684
618,55,38,17,13,42,472,405,26.145454545454545,22.180235387683936,27.02126977858585,51.6,48.4
619,55,39,16,12,43,473,405,26.21818181818182,21.444692066528226,27.955307933471776,51.127272727272725,48.872727272727275
620,55,39,16,13,42,474,405,26.272727272727273,20.24627524126228,28.32013043754225,50.72727272727273,49.27272727272727
621,55,39,16,12,43,475,405,26.254545454545454,20.044167184751746,27.508519732807034,51.21818181818182,48.78181818181818
622,56,42,14,14,42,475,405,26.785714285714285,19.935006230612796,28.154279483672923,51.19642857142857,48.80357142857143
623,53,40,13,12,41,478,405,26.0188679245283,20.71797731485038,26.47070193043264,50.509433962264154,49.490566037735846
624,53,39,14,11,42,479,405,25.9811320754717,20.290303233676678,27.66449970139476,50.0377358490566,49.9622641509434
625,53,39,14,13,40,479,405,26.9811320754717,20.513303978763354,26.73197904010457,50.0377358490566,49.9622641509434
626,52,40,12,13,39,480,405,27.51923076923077,20.35133775206976,26.879439610292,50.0,50.0
627,53,41,12,15,38,480,405,28.0,20.937934332080996,26.571499630183155,49.132075471698116,50.867924528301884
628,53,40,13,15,38,480,406,28.22641509433962,18.94159670348319,27.427672424000242,50.264150943396224,49.735849056603776
629,53,42,11,14,39,481,406,28.245283018867923,19.879901108952318,25.742740400481644,49.60377358490566,50.39622641509434
630,53,42,11,14,39,481,406,29.245283018867923,20.169639852596237,24.50960543042263,49.60377358490566,50.39622641509434
631,51,39,12,14,37,484,407,27.176470588235293,19.96524937059317,24.277079801660527,47.96078431372549,52.03921568627451
632,54,40,14,14,40,484,407,26.666666666666668,19.44026851145423,28.17084259965688,47.166666666666664,52.833333333333336
633,57,40,17,13,44,485,407,25.350877192982455,19.975479893107643,29.778906071804638,48.21052631578947,51.78947368421053
634,57,39,18,12,45,486,407,25.43859649122807,20.30930353713467,26.23443030414587,47.59649122807018,52.40350877192982
635,56,38,18,12,44,488,407,24.982142857142858,21.413925248718677,25.336074751281323,47.92857142857143,52.07142857142857
636,58,39,19,12,46,488,407,25.120689655172413,21.054629987771325,27.79019759843557,47.224137931034484,52.775862068965516
637,59,40,19,12,47,488,407,25.694915254237287,20.96406344713424,27.03593655286576,47.54237288135593,52.45762711864407
638,62,39,23,13,49,489,407,24.629032258064516,23.053941293337054,28.0589619324694,48.82258064516129,51.17741935483871
639,63,40,23,13,50,489,407,25.238095238095237,24.10382797115854,25.388235520904953,49.38095238095238,50.61904761904762
640,61,39,22,12,49,491,407,25.19672131147541,23.747889725210207,23.84093362796073,50.131147540983605,49.868852459016395
641,61,38,23,12,49,491,408,25.491803278688526,23.255325371639234,26.28565823491815,50.16393442622951,49.83606557377049
642,60,36,24,10,50,491,410,25.483333333333334,21.078876522976007,29.521123477023995,50.0,50.0
643,59,36,23,10,49,492,410,26.050847457627118,19.76973646709436,30.92872360719221,49.728813559322035,50.271186440677965
644,59,35,24,10,49,493,410,26.16949152542373,20.806484302814415,30.956227561592364,49.6271186440678,50.3728813559322
645,58,34,24,9,49,495,410,25.79310344827586,22.720180456778643,28.855232953109,49.91379310344828,50.08620689655172
646,61,35,26,11,50,495,410,25.524590163934427,23.19379481165632,29.724237975228924,48.9344262295082,51.0655737704918
647,61,37,24,11,50,495,410,26.524590163934427,23.129096700608514,27.329919692834107,48.9344262295082,51.0655737704918
648,62,38,24,15,47,495,410,27.096774193548388,23.958918664392517,26.92817810980103,49.03225806451613,50.96774193548387
649,59,39,20,14,45,498,411,26.06779661016949,24.062993772240347,26.581221151586515,49.50847457627118,50.49152542372882
650,59,40,19,13,46,499,411,26.203389830508474,24.95302285864639,26.126562318646787,50.0,50.0
651,59,39,20,12,47,500,412,25.440677966101696,25.164286349472896,28.248405788809052,50.101694915254235,49.898305084745765
652,57,38,19,11,46,502,413,24.57894736842105,24.704158659678882,29.418648357864974,48.73684210526316,51.26315789473684
653,55,36,19,10,45,503,415,23.70909090909091,20.270908858106726,33.975021364748116,49.38181818181818,50.61818181818182
654,54,38,16,11,43,505,415,23.22222222222222,18.69068519292922,35.67847280528131,47.74074074074074,52.25925925925926
655,56,39,17,11,45,505,415,23.392857142857142,19.880052468852103,35.8699475311479,48.625,51.375
656,57,39,18,11,46,505,415,23.982456140350877,20.289682312672316,35.02610716101189,49.14035087719298,50.85964912280702
657,58,40,18,11,47,505,415,24.56896551724138,21.16394818130195,34.353293198008394,49.741379310344826,50.258620689655174
658,59,41,18,13,46,505,415,25.152542372881356,21.69390034367684,33.83152338513673,49.101694915254235,50.898305084745765
659,59,41,18,13,46,505,415,26.152542372881356,21.898022492543394,32.77994360915152,49.101694915254235,50.898305084745765
660,59,40,19,13,46,506,415,26.23728813559322,21.080859295944283,34.715750873547236,48.847457627118644,51.152542372881356
661,61,41,20,13,48,506,415,26.37704918032787,21.971575940953162,34.79891586232553,49.80327868852459,50.19672131147541
662,62,45,17,13,49,506,415,26.951612903225808,23.348263109593063,32.99044656782629,50.32258064516129,49.67741935483871
663,61,43,18,13,48,508,415,26.721311475409838,24.6417494602062,31.60914728998191,51.83606557377049,48.16393442622951
664,61,42,19,12,49,510,415,25.918032786885245,26.117159895954128,31.97726491059247,50.77049180327869,49.22950819672131
665,63,41,22,13,50,511,415,25.22222222222222,28.53176117614122,30.18252453814449,50.111111111111114,49.888888888888886
666,62,41,21,13,49,512,416,25.0,28.943756234552517,27.679567732140438,49.483870967741936,50.516129032258064
667,58,39,19,14,44,515,417,24.120689655172413,29.214571950140915,28.578531479090135,48.689655172413794,51.310344827586206
668,57,38,19,14,43,515,419,24.157894736842106,26.665511421728077,32.90901772484842,50.29824561403509,49.70175438596491
669,57,38,19,14,43,516,419,24.24561403508772,26.07163883207959,32.92836116792041,49.94736842105263,50.05263157894737
670,58,38,20,14,44,516,420,24.051724137931036,23.73896729812391,37.36448097773816,51.94827586206897,48.05172413793103
671,57,39,18,13,44,516,421,24.82456140350877,22.222359434793514,38.32150021432929,52.0,48.0
672,57,39,18,13,44,516,421,25.82456140350877,24.585059298955986,35.958800350166825,52.0,48.0
673,55,38,17,12,43,518,422,24.8,23.1251590662978,37.44808578122023,52.345454545454544,47.654545454545456
674,57,39,18,12,45,518,422,24.92982456140351,23.22764560051191,38.78989825913721,51.07017543859649,48.92982456140351
675,58,39,19,12,46,518,422,25.5,23.026143437528223,37.31868414867867,50.87931034482759,49.12068965517241
676,58,39,19,14,44,518,422,26.5,22.851340671408362,36.63141794928129,50.87931034482759,49.12068965517241
677,58,41,17,16,42,518,422,27.5,22.329048653497413,37.15370996719224,50.87931034482759,49.12068965517241
678,59,41,18,17,42,519,422,27.033898305084747,23.058663825815202,38.02608193689667,50.96610169491525,49.03389830508475
679,60,42,18,17,43,519,422,27.583333333333332,23.03527473588063,36.71472526411937,51.18333333333333,48.81666666666667
680,62,45,17,19,43,519,422,27.693548387096776,24.943719479839338,36.104667616934854,50.88709677419355,49.11290322580645
681,63,48,15,19,44,519,422,28.253968253968253,26.211699444779423,34.53433230125233,51.25396825396825,48.74603174603175
682,63,47,16,19,44,519,423,28.53968253968254,27.657031083048558,32.96201653599907,51.57142857142857,48.42857142857143
683,63,47,16,20,43,520,423,28.714285714285715,27.880078930229867,32.453254403103465,51.15873015873016,48.84126984126984
684,62,46,16,19,43,522,423,28.532258064516128,27.874879594172512,30.35457237458083,51.354838709677416,48.645161290322584
685,60,44,16,18,42,524,424,27.816666666666666,25.508958209107035,31.944147535968074,51.06666666666667,48.93333333333333
686,62,45,17,20,42,525,424,27.080645161290324,26.20075513647137,33.83361924646314,50.354838709677416,49.645161290322584
687,61,42,19,20,41,527,425,25.983606557377048,23.6889661916328,32.63319272837406,51.01639344262295,48.98360655737705
688,61,39,22,17,44,530,425,24.360655737704917,23.827254445525067,31.10681421197727,49.85245901639344,50.14754098360656
689,62,39,23,17,45,531,425,24.129032258064516,24.098378985085347,30.159685531043685,48.38709677419355,51.61290322580645
690,63,40,23,17,46,531,425,24.746031746031747,25.206719662391187,28.72978827411675,48.42857142857143,51.57142857142857
691,63,42,21,17,46,531,425,25.746031746031747,26.737581316374225,26.405275826482917,48.42857142857143,51.57142857142857
692,63,42,21,17,46,531,425,26.746031746031747,28.109122429260847,25.033734713596296,48.42857142857143,51.57142857142857
693,63,41,22,16,47,532,425,26.936507936507937,29.85048016847918,23.197138879139864,48.111111111111114,51.888888888888886
694,64,40,24,16,48,533,425,26.609375,31.41687419153552,23.54208501451884,47.296875,52.703125
695,62,42,20,18,44,533,428,27.483870967741936,27.994640326625667,26.057493788282486,47.54838709677419,52.45161290322581
696,65,43,22,17,48,534,428,26.43076923076923,28.5327983991514,27.005663139310133,47.323076923076925,52.676923076923075
697,66,43,23,16,50,535,428,26.136363636363637,28.908612629947708,26.75805403671896,46.81818181818182,53.18181818181818
698,66,43,23,18,48,535,428,27.136363636363637,27.797124161346655,26.354390990168497,46.81818181818182,53.18181818181818
699,64,39,25,18,46,537,430,25.78125,26.38879083378672,29.688145239576297,46.21875,53.78125
700,65,41,24,18,47,537,430,26.384615384615383,25.65647852195005,29.620444554973027,46.89230769230769,53.10769230769231
701,64,41,23,18,46,539,430,26.1875,26.027149322916515,28.191600677083482,47.703125,52.296875
702,61,40,21,17,44,540,432,26.0,23.893628306394458,29.431967076953423,45.540983606557376,54.459016393442624
703,58,39,19,16,42,543,433,25.120689655172413,23.62572181887596,29.45546547293538,44.827586206896555,55.172413793103445
704,58,40,18,17,41,544,433,25.24137931034483,24.952492961957965,28.188957434082294,45.03448275862069,54.96551724137931
705,59,40,19,17,42,544,435,24.47457627118644,21.728853720993957,33.902116539576326,44.0,56.0
706,57,39,18,16,41,545,436,24.859649122807017,20.574286999920982,34.092379666745686,44.3859649122807,55.6140350877193
707,55,37,18,14,41,547,436,24.618181818181817,19.979885140390326,32.776790904644606,43.527272727272724,56.472727272727276
708,56,37,19,14,42,547,436,25.178571428571427,18.824326315457288,34.53281654168557,42.964285714285715,57.035714285714285
709,54,34,20,13,41,548,438,24.37037037037037,15.468895612001951,37.677328265084,43.48148148148148,56.51851851851852
710,55,36,19,13,42,548,438,24.927272727272726,15.854023035885914,37.00052241865954,44.0,56.0
711,58,38,20,13,45,548,438,24.637931034482758,17.55166656419872,35.689712746146114,43.48275862068966,56.51724137931034
712,56,39,17,12,44,550,438,24.571428571428573,15.242046421841678,34.77581072101547,43.42857142857143,56.57142857142857
713,58,40,18,14,44,550,438,24.724137931034484,16.10241506832437,35.06999872477908,42.86206896551724,57.13793103448276
714,60,41,19,14,46,550,438,24.9,16.948984210569865,33.351015789430136,43.96666666666667,56.03333333333333
715,59,41,18,13,46,551,438,25.406779661016948,16.632785367348134,31.112977344516274,43.67796610169491,56.32203389830509
716,58,39,19,13,45,553,438,25.051724137931036,17.8502227092384,30.956351916611656,45.51724137931034,54.48275862068966
717,61,41,20,13,48,553,438,24.81967213114754,18.529011203140218,32.11033305915486,46.24590163934426,53.75409836065574
718,59,40,19,12,47,555,438,24.847457627118644,18.28333607870949,28.869206294171867,45.91525423728814,54.08474576271186
719,61,41,20,12,49,555,438,25.0327868852459,19.8061829100222,27.898735122764684,46.67213114754098,53.32786885245902
720,61,41,20,12,49,556,438,25.19672131147541,19.128162359358683,27.806263870149515,46.52459016393443,53.47540983606557
721,61,42,19,11,50,557,438,25.262295081967213,19.731432043570095,26.07184664495449,46.868852459016395,53.131147540983605
722,61,43,18,11,50,557,438,26.262295081967213,19.4187359772188,25.728805006387756,46.868852459016395,53.131147540983605
723,64,43,21,11,53,557,438,26.03125,20.18596910783497,27.32965589216503,47.1875,52.8125
724,65,44,21,13,52,557,438,26.630769230769232,20.655797798813484,25.390356047340365,47.44615384615385,52.55384615384615
725,64,42,22,13,51,559,438,26.25,20.701365103817146,23.548634896182858,46.515625,53.484375
726,64,42,22,13,51,560,438,26.375,21.28127287556573,23.421852124434267,46.125,53.875
727,65,43,22,13,52,561,438,26.153846153846153,21.419638956547757,25.072668735759937,45.84615384615385,54.15384615384615
728,66,43,23,13,53,562,438,25.939393939393938,22.662232326832353,21.88322221862219,46.78787878787879,53.21212121212121
729,67,45,22,13,54,563,438,25.791044776119403,24.524934029945022,20.937752537219158,46.35820895522388,53.64179104477612
730,66,44,22,14,52,565,438,25.62121212121212,26.361062421239666,18.093483033305787,45.696969696969695,54.303030303030305
731,64,43,21,13,51,566,439,25.890625,24.30848453668883,19.432119368325292,46.6875,53.3125
732,66,44,22,13,53,566,439,26.106060606060606,26.557029859638234,19.761151958543586,46.93939393939394,53.06060606060606
733,66,45,21,11,55,566,441,25.757575757575758,25.452752904913268,21.39573194357158,47.5,52.5
734,63,42,21,10,53,566,444,25.88888888888889,20.981450986224125,24.83091810485866,48.857142857142854,51.142857142857146
735,61,42,19,10,51,568,444,25.918032786885245,19.83402184128511,26.90433173676002,48.73770491803279,51.26229508196721
736,61,42,19,10,51,568,444,26.918032786885245,20.824673252607464,26.372048058867946,48.73770491803279,51.26229508196721
737,61,44,17,10,51,568,444,27.918032786885245,19.870964955249352,27.32575635622606,48.73770491803279,51.26229508196721
738,61,43,18,10,51,569,444,28.081967213114755,19.17977511027782,29.262847840541856,49.26229508196721,50.73770491803279
739,59,42,17,8,51,572,444,27.25423728813559,19.286031361248764,28.13769745231056,49.847457627118644,50.152542372881356
740,58,42,16,7,51,574,444,26.913793103448278,18.485216679725177,28.23892125130931,50.86206896551724,49.13793103448276
741,60,43,17,9,51,574,444,27.016666666666666,19.541128738955276,28.842204594378057,50.55,49.45
742,61,43,18,8,53,575,444,26.57377049180328,19.998195186620784,26.401941959879583,50.704918032786885,49.295081967213115
743,61,42,19,8,53,576,444,26.65573770491803,20.92749364112807,25.957751284829406,51.21311475409836,48.78688524590164
744,61,44,17,10,51,576,444,27.65573770491803,21.836216212068113,24.393291984653196,51.21311475409836,48.78688524590164
745,62,47,15,10,52,576,444,28.20967741935484,22.305157276750457,24.775487884539867,51.774193548387096,48.225806451612904
746,62,46,16,10,52,578,444,27.580645161290324,22.269435954977983,25.707322715128957,51.596774193548384,48.403225806451616
747,61,45,16,12,49,580,444,27.19672131147541,22.76218913394886,23.09026988244458,51.09836065573771,48.90163934426229
748,60,46,14,12,48,580,445,27.85,20.189319740986214,25.009990186516845,50.71666666666667,49.28333333333333
749,62,47,15,14,48,580,445,27.951612903225808,20.63796463171907,26.91042246505513,50.17741935483871,49.82258064516129
750,63,47,16,13,50,581,445,27.50793650793651,22.63159857443056,26.431893489061505,49.58730158730159,50.41269841269841
751,64,46,18,14,50,582,445,27.203125,23.423613327121398,25.654511672878602,50.71875,49.28125
752,65,45,20,14,51,583,445,26.907692307692308,23.674357799453468,24.23133270047188,50.6,49.4
753,65,45,20,16,49,583,445,27.907692307692308,23.109608421292133,23.428853117169407,50.6,49.4
754,68,44,24,15,53,584,445,26.852941176470587,25.747454073119094,23.855487103351493,50.279411764705884,49.720588235294116
755,67,45,22,15,52,585,445,27.37313432835821,27.052367686038384,19.156587537842213,50.582089552238806,49.417910447761194
756,65,43,22,14,51,588,445,26.753846153846155,27.810622858427827,18.84308880266744,48.92307692307692,51.07692307692308
757,64,43,21,13,51,589,445,27.34375,28.88112176918313,17.43137823081687,49.609375,50.390625
758,62,42,20,14,48,589,447,27.774193548387096,26.975943500816904,18.777943406496515,48.806451612903224,51.193548387096776
759,60,42,18,13,47,590,449,27.316666666666666,23.012299001513266,24.950969906302202,49.28333333333333,50.71666666666667
760,63,42,21,13,50,590,449,27.015873015873016,24.188424629492985,25.938559497491138,48.111111111111114,51.888888888888886
761,61,41,20,14,47,591,450,27.327868852459016,22.93898234221978,24.352048771302474,46.85245901639344,53.14754098360656
762,62,40,22,13,49,593,450,25.983870967741936,22.540306110964842,27.975822921293222,48.564516129032256,51.435483870967744
763,64,40,24,13,51,593,450,26.171875,23.480104057829998,26.488645942170002,48.46875,51.53125
764,64,40,24,15,49,595,450,25.421875,22.116234177458065,29.33506745906677,46.65625,53.34375
765,68,40,28,15,53,596,450,24.16176470588235,23.070315301973373,30.4327770907485,47.794117647058826,52.205882352941174
766,69,41,28,17,52,597,450,23.942028985507246,24.855328601135607,26.724381543791925,48.30434782608695,51.69565217391305
767,68,41,27,15,53,599,450,23.544117647058822,26.59651814058728,25.315246565295077,48.63235294117647,51.36764705882353
768,69,42,27,15,54,600,450,23.44927536231884,26.85724733714462,26.287680199087266,48.36231884057971,51.63768115942029
769,70,43,27,17,53,600,450,24.114285714285714,26.607726899336114,25.97798738637817,48.02857142857143,51.97142857142857
770,70,47,23,17,53,600,450,25.114285714285714,26.414379546589135,25.45704902483944,48.02857142857143,51.97142857142857
771,70,46,24,17,53,601,450,25.357142857142858,26.895467633992862,25.475960937435712,48.07142857142857,51.92857142857143
772,69,45,24,16,53,602,451,25.246376811594203,27.05005701903471,25.333941985479086,47.42028985507246,52.57971014492754
773,70,44,26,18,52,602,452,25.257142857142856,26.7792933927523,26.59213517867627,48.2,51.8
774,69,40,29,16,53,604,454,23.695652173913043,23.50420403693376,30.347417161266495,49.21739130434783,50.78260869565217
775,70,41,29,16,54,604,454,24.357142857142858,25.41259243855963,28.03026470429751,49.371428571428574,50.628571428571426
776,70,44,26,16,54,604,454,25.357142857142858,24.97766646945871,27.75090495911272,49.371428571428574,50.628571428571426
777,69,43,26,15,54,605,454,25.942028985507246,26.1683976298777,26.556240051281726,48.89855072463768,51.10144927536232
778,68,44,24,17,51,606,454,26.573529411764707,26.678142876657702,26.50444376439221,48.60294117647059,51.39705882352941
779,71,47,24,17,54,606,454,26.450704225352112,28.959172303282,27.463362907985605,48.929577464788736,51.070422535211264
780,71,46,25,22,49,607,455,26.6056338028169,29.963415363098136,26.09292266507088,50.15492957746479,49.84507042253521
781,71,51,20,24,47,607,458,26.87323943661972,29.158721529580816,27.883267974405886,50.394366197183096,49.605633802816904
782,71,50,21,23,48,609,460,25.056338028169016,29.55758542614803,28.033963869632757,48.91549295774648,51.08450704225352
783,67,46,21,20,47,612,462,23.940298507462686,28.28144903512362,28.390631119096966,49.507462686567166,50.492537313432834
784,64,44,20,17,47,614,463,23.53125,25.815897076523843,28.591579635270286,49.328125,50.671875
785,62,43,19,16,46,615,464,23.612903225806452,24.375902525607355,31.495065216328133,48.903225806451616,51.096774193548384
786,62,43,19,16,46,616,464,23.548387096774192,23.93897063218937,33.83037642547982,48.564516129032256,51.435483870967744
787,64,44,20,20,44,616,464,23.8125,23.18770707115646,35.84354292884354,48.625,51.375
788,63,43,20,20,43,616,465,24.603174603174605,20.004104170329175,37.916530750305746,49.38095238095238,50.61904761904762
789,60,42,18,18,42,617,467,24.6,17.594265321107432,39.58906801222591,47.63333333333333,52.36666666666667
790,59,42,17,17,42,618,467,24.949152542372882,17.27868285560359,40.115916582270145,47.66101694915254,52.33898305084746
791,59,43,16,17,42,618,467,25.949152542372882,17.954235688799287,39.62203549764139,47.66101694915254,52.33898305084746
792,60,43,17,17,43,618,467,26.516666666666666,18.060760559218178,40.85590610744848,47.9,52.1
793,61,43,18,17,44,618,467,27.081967213114755,18.428214249014403,40.99801525918232,47.16393442622951,52.83606557377049
794,62,42,20,16,46,619,467,26.822580645161292,19.466894809157452,40.993726013907725,48.20967741935484,51.79032258064516
795,63,44,19,20,43,619,467,27.396825396825395,20.029057252499104,38.923323699881855,47.507936507936506,52.492063492063494
796,62,46,16,19,43,620,467,27.822580645161292,20.348838411070897,38.15641273682835,47.12903225806452,52.87096774193548
797,62,48,14,18,44,621,467,27.93548387096774,20.26497588256769,39.7745323875653,47.354838709677416,52.645161290322584
798,64,50,14,18,46,621,467,28.0625,21.393899490097976,39.77797550990202,47.640625,52.359375
799,65,52,13,18,47,621,467,28.630769230769232,22.61777825705683,38.351452512173935,48.41538461538462,51.58461538461538
800,64,51,13,18,46,622,468,28.609375,21.424753268291607,38.9971217317084,49.25,50.75
801,65,50,15,18,47,623,468,28.353846153846153,23.3314668209493,37.683917794435324,49.13846153846154,50.86153846153846
802,66,51,15,18,48,623,468,28.924242424242426,23.501892664665792,35.8920467292736,49.40909090909091,50.59090909090909
803,63,49,14,17,46,625,469,28.80952380952381,22.46843014584095,36.69907816878938,49.888888888888886,50.111111111111114
804,62,48,14,16,46,627,469,28.612903225806452,20.434164281888982,39.56334666852681,50.403225806451616,49.596774193548384
805,64,48,16,16,48,627,469,28.71875,21.65378122035306,40.14309377964693,50.8125,49.1875
806,63,46,17,15,48,628,470,28.58730158730159,21.008873759391594,40.75014108006519,50.57142857142857,49.42857142857143
807,64,45,19,16,48,629,470,28.3125,22.279379483691347,39.37687051630865,50.625,49.375
808,66,45,21,16,50,630,470,27.666666666666668,24.850411565613197,36.558679343477706,51.27272727272727,48.72727272727273
809,67,45,22,18,49,630,470,28.253731343283583,26.96994694437487,32.13453066756543,51.40298507462686,48.59701492537314
810,67,46,21,18,49,630,471,28.55223880597015,28.27634232532851,31.186344241835673,51.1044776119403,48.8955223880597
811,65,45,20,17,48,632,472,27.784615384615385,29.375975660782366,30.070178185371475,50.38461538461539,49.61538461538461
812,63,43,20,19,44,633,473,28.11111111111111,28.342319364981122,31.213236190574435,50.38095238095238,49.61904761904762
813,65,43,22,23,42,633,473,28.246153846153845,30.08661124925406,31.713388750745946,50.6,49.4
814,67,45,22,23,44,633,474,27.671641791044777,30.745271011143828,32.09054988437856,49.74626865671642,50.25373134328358
815,63,42,21,22,41,636,475,26.904761904761905,29.208251906867826,30.344155072686142,49.888888888888886,50.111111111111114
816,63,39,24,19,44,638,476,25.396825396825395,28.41451110613116,33.635338455667835,50.285714285714285,49.714285714285715
817,63,39,24,18,45,638,477,25.555555555555557,27.201423290406016,33.877941788959056,50.93650793650794,49.06349206349206
818,63,39,24,17,46,639,477,25.61904761904762,28.653276079022657,32.6006921749456,51.63492063492063,48.36507936507937
819,63,39,24,18,45,640,477,25.761904761904763,29.619693455825125,31.668915970224255,51.79365079365079,48.20634920634921
820,62,39,23,16,46,641,479,25.306451612903224,26.080318383024554,35.83625228154362,51.435483870967744,48.564516129032256
821,61,39,22,16,45,642,480,25.016393442622952,24.048522603405875,37.90229706872528,49.42622950819672,50.57377049180328
822,62,39,23,15,47,643,480,24.758064516129032,23.475756214405106,37.04446747704495,50.83870967741935,49.16129032258065
823,62,37,25,14,48,644,481,24.177419354838708,23.01542188156061,38.597481344245836,49.37096774193548,50.62903225806452
824,63,40,23,14,49,644,481,24.793650793650794,24.572600024271704,35.7289872773156,50.0,50.0
825,65,42,23,14,51,644,481,25.03076923076923,27.411252218770954,32.86567085815212,49.15384615384615,50.84615384615385
826,66,43,23,14,52,644,481,25.651515151515152,29.48438690362743,29.81864339940287,49.303030303030305,50.696969696969695
827,65,43,22,14,51,645,481,26.23076923076923,29.752021975585755,29.2018241782604,49.09230769230769,50.90769230769231
828,66,42,24,14,52,645,482,26.12121212121212,28.801588698302744,30.909815935419118,49.696969696969695,50.303030303030305
829,67,41,26,15,52,646,483,25.238805970149254,28.811325999698397,30.682317808125884,50.014925373134325,49.985074626865675
830,67,42,25,15,52,647,483,25.328358208955223,29.11968408353599,27.831304579761888,50.02985074626866,49.97014925373134
831,65,40,25,16,49,649,484,24.553846153846155,28.75156602924516,29.24764820236113,51.13846153846154,48.86153846153846
832,65,42,23,16,49,650,485,23.96923076923077,28.125996767799148,30.181695539893163,50.784615384615385,49.215384615384615
833,62,40,22,14,48,653,485,23.451612903225808,27.64126948691805,28.375475340925203,50.58064516129032,49.41935483870968
834,63,40,23,14,49,653,486,23.428571428571427,26.788012946454717,31.386590228148457,49.73015873015873,50.26984126984127
835,63,39,24,16,47,654,487,22.96825396825397,26.020786540354756,33.37603885647064,50.44444444444444,49.55555555555556
836,63,39,24,15,48,656,487,22.26984126984127,24.357148137804554,33.286352576432314,50.857142857142854,49.142857142857146
837,65,39,26,14,51,657,487,21.630769230769232,25.759781842278823,32.82483354233656,49.753846153846155,50.246153846153845
838,65,39,26,15,50,658,488,21.29230769230769,23.936094442869738,34.74082863405334,50.38461538461539,49.61538461538461
839,67,40,27,14,53,659,488,20.865671641791046,24.655107677139096,33.10608635271166,51.208955223880594,48.791044776119406
840,67,40,27,13,54,660,488,21.08955223880597,24.360203013685094,32.4756178818373,50.95522388059702,49.04477611940298
841,68,40,28,13,55,660,489,21.220588235294116,24.186813013400695,33.180834045422834,51.955882352941174,48.044117647058826
842,66,40,26,12,54,661,490,21.424242424242426,23.19559838580463,31.425613735407495,51.10606060606061,48.89393939393939
843,69,40,29,14,55,661,490,21.492753623188406,23.94987023550883,31.97766599637523,50.84057971014493,49.15942028985507
844,71,42,29,14,57,661,490,21.887323943661972,24.423717251649578,29.64670528356169,49.80281690140845,50.19718309859155
845,72,43,29,14,58,661,490,22.583333333333332,26.207525750611552,26.639696471610673,50.291666666666664,49.708333333333336
846,70,42,28,14,56,662,492,22.37142857142857,26.582411001257807,25.472275903007343,50.25714285714286,49.74285714285714
847,70,42,28,14,56,662,493,22.814285714285713,26.47884813244761,26.26400901040953,50.357142857142854,49.642857142857146
848,72,44,28,15,57,662,494,22.61111111111111,27.134660452899208,26.1548296984203,51.111111111111114,48.888888888888886
849,73,42,31,14,59,662,496,22.273972602739725,26.104441052600773,27.69319249146194,50.657534246575345,49.342465753424655
850,74,43,31,15,59,663,496,22.27027027027027,26.55012085150991,25.655786537031364,49.91891891891892,50.08108108108108
851,74,43,31,17,57,663,497,22.85135135135135,25.54333505828646,27.010718995767593,49.67567567567568,50.32432432432432
852,73,43,30,18,55,664,498,22.84931506849315,26.37820837485163,25.04652486155978,51.0,49.0
853,73,44,29,18,55,665,499,22.561643835616437,27.21002621236351,23.86125409134746,52.054794520547944,47.945205479452056
854,75,44,31,22,53,665,500,22.573333333333334,28.143687856769823,25.28297880989684,52.0,48.0
855,76,46,30,22,54,665,501,22.855263157894736,29.321932789813875,22.967540894396645,50.75,49.25
856,76,46,30,22,54,665,503,23.06578947368421,29.53879566455011,24.170178304545104,50.88157894736842,49.11842105263158
857,75,44,31,21,54,666,505,22.506666666666668,30.399101513939307,23.550457284472582,51.85333333333333,48.14666666666667
858,75,43,32,20,55,667,506,22.293333333333333,31.15714501603084,23.30023978806599,51.14666666666667,48.85333333333333
859,75,43,32,18,57,668,508,21.72,31.174686535369048,24.798646797964285,52.12,47.88
860,70,41,29,16,54,668,513,21.47142857142857,25.538250079419214,29.20425842658939,51.44285714285714,48.55714285714286
861,68,40,28,16,52,669,514,21.779411764705884,25.616268682425925,29.60431955286819,50.720588235294116,49.279411764705884
862,69,39,30,16,53,669,515,22.014492753623188,25.902798659671717,29.53198394902394,49.73913043478261,50.26086956521739
863,70,39,31,14,56,670,516,21.214285714285715,27.11973272870175,27.478571294601505,48.957142857142856,51.042857142857144
864,67,38,29,13,54,672,517,21.19402985074627,28.576957079583728,22.70662500996851,50.26865671641791,49.73134328358209
865,66,39,27,13,53,672,518,22.03030303030303,28.7954501703426,23.7045498296574,50.378787878787875,49.621212121212125
866,67,39,28,17,50,672,520,21.671641791044777,28.266621729518835,26.71573596838292,50.23880597014925,49.76119402985075
867,64,38,26,15,49,674,521,21.625,27.373145884101504,24.158104115898496,49.828125,50.171875
868,63,38,25,14,49,676,521,21.142857142857142,28.780210411273618,22.762224408207537,50.07936507936508,49.92063492063492
869,62,38,24,14,48,676,522,22.0,28.710873100259338,22.347929986348984,50.016129032258064,49.983870967741936
870,60,38,22,13,47,677,524,21.55,27.940888062616462,23.407659851922233,49.88333333333333,50.11666666666667
871,60,40,20,13,47,677,525,21.95,28.05655184837554,23.62678148495779,49.88333333333333,50.11666666666667
872,60,41,19,15,45,677,526,22.683333333333334,26.335618493069795,25.734913508297574,50.88333333333333,49.11666666666667
873,62,43,19,15,47,677,526,22.951612903225808,27.5969750632036,26.612702356151235,50.66129032258065,49.33870967741935
874,60,43,17,19,41,677,528,24.1,23.96918692398098,28.83081307601902,49.833333333333336,50.166666666666664
875,61,46,15,19,42,677,528,24.704918032786885,25.01113090300643,29.201983851091935,50.08196721311475,49.91803278688525
876,63,46,17,19,44,677,528,24.92063492063492,26.524834826124824,27.983101681811682,50.25396825396825,49.74603174603175
877,65,46,19,19,46,677,528,25.153846153846153,27.63014289160563,26.677549416086674,49.6,50.4
878,65,47,18,19,46,677,529,25.907692307692308,27.285862400069504,26.02182990762281,50.56923076923077,49.43076923076923
879,64,47,17,19,45,677,530,26.65625,25.827449173205828,27.672550826794172,50.84375,49.15625
880,66,49,17,19,47,677,530,26.848484848484848,26.60227958126507,28.39772041873493,51.78787878787879,48.21212121212121
881,67,48,19,19,48,677,531,26.91044776119403,26.583343365677205,28.67467918678603,51.149253731343286,48.850746268656714
882,65,49,16,17,48,679,531,26.892307692307693,27.946794041960676,25.007052111885475,52.10769230769231,47.89230769230769
883,66,47,19,19,47,679,533,26.333333333333332,28.297055568792018,28.021126249389802,52.378787878787875,47.621212121212125
884,65,47,18,19,46,679,534,27.446153846153845,28.450918831272134,26.364465784112483,53.01538461538462,46.98461538461538
885,65,46,19,19,46,679,535,27.815384615384616,27.748263225132654,26.977970867410146,53.93846153846154,46.06153846153846
886,65,46,19,20,45,680,535,27.984615384615385,28.56638702325921,25.71393451520233,53.707692307692305,46.292307692307695
887,65,46,19,20,45,680,535,28.984615384615385,28.732325714406617,24.929212747131842,53.707692307692305,46.292307692307695
888,64,46,18,22,42,681,536,28.890625,27.20902783170932,27.65028973822428,53.75,46.25
889,65,48,17,22,43,681,536,29.446153846153845,27.17291552444103,28.427084475558964,53.23076923076923,46.76923076923077
890,64,46,18,21,43,682,537,29.8125,26.420850327412666,27.407274672587334,53.609375,46.390625
891,66,46,20,21,45,682,538,29.666666666666668,26.43223437349813,28.35564441438066,52.621212121212125,47.378787878787875
892,66,47,19,21,45,682,539,30.09090909090909,25.075270166157527,28.227760136872774,52.46969696969697,47.53030303030303
893,66,46,20,18,48,685,539,28.272727272727273,27.217981934390927,26.238286262535894,52.72727272727273,47.27272727272727
894,67,46,21,18,49,686,539,28.08955223880597,29.33900951746925,23.332632273575527,51.850746268656714,48.149253731343286
895,66,45,21,19,47,687,539,28.636363636363637,30.564035862266948,20.087479289248204,52.25757575757576,47.74242424242424
896,66,45,21,21,45,688,539,28.818181818181817,31.16190523435004,20.565367492922693,51.75757575757576,48.24242424242424
897,66,47,19,21,45,689,540,28.803030303030305,31.901028475237514,19.993416183802935,51.484848484848484,48.515151515151516
898,67,46,21,21,46,690,540,28.55223880597015,32.95437925539241,19.38890432669714,50.46268656716418,49.53731343283582
899,66,47,19,22,44,691,540,28.954545454545453,33.02026860754674,17.25260249080546,49.84848484848485,50.15151515151515
900,60,42,18,19,41,694,543,28.133333333333333,29.500381237910187,20.630217106484384,47.45,52.55
901,61,40,21,20,41,696,543,26.868852459016395,27.37970346351004,26.30225717224933,46.557377049180324,53.442622950819676
902,65,41,24,20,45,696,543,26.215384615384615,29.715374102783084,24.223087435678455,47.15384615384615,52.84615384615385
903,67,40,27,20,47,696,544,25.71641791044776,28.920711026933045,24.826828690068997,46.850746268656714,53.149253731343286
904,65,38,27,19,46,698,545,25.03076923076923,24.912092179223446,26.267274326833487,47.44615384615385,52.55384615384615
905,65,36,29,18,47,701,545,23.53846153846154,25.225889038139353,28.921964906510464,47.33846153846154,52.66153846153846
906,63,35,28,19,44,703,545,23.603174603174605,23.843339212671356,28.09316872383658,47.492063492063494,52.507936507936506
907,64,36,28,21,43,703,546,23.546875,24.137822884698284,30.768427115301716,47.390625,52.609375
908,64,34,30,20,44,705,547,22.078125,25.433946930788835,29.475498189321414,46.890625,53.109375
909,66,36,30,19,47,706,547,21.575757575757574,25.902027736713706,28.461608626922658,47.13636363636363,52.86363636363637
910,65,35,30,17,48,708,548,20.446153846153845,26.123630602108452,25.906854251996243,46.63076923076923,53.36923076923077
911,68,36,32,17,51,708,548,20.544117647058822,26.60552044274263,25.497420733727964,45.89705882352941,54.10294117647059
912,68,32,36,14,54,708,552,18.86764705882353,23.192692831613517,30.957008668643432,44.88235294117647,55.11764705882353
913,69,33,36,15,54,708,553,18.956521739130434,23.383144519887452,29.603429777328397,46.17391304347826,53.82608695652174
914,67,32,35,13,54,709,554,19.029850746268657,23.362956248951377,27.68181987045161,45.59701492537314,54.40298507462686
915,68,34,34,13,55,709,554,19.75,24.404744437466345,26.84525556253366,45.05882352941177,54.94117647058823
916,67,32,35,12,55,710,555,19.64179104477612,25.048280091849758,25.206756375639543,44.26865671641791,55.73134328358209
917,67,30,37,14,53,711,556,19.26865671641791,25.803953496602578,24.919706899456646,44.56716417910448,55.43283582089552
918,67,34,33,16,51,712,556,19.37313432835821,26.050473892417088,24.21818282400082,45.64179104477612,54.35820895522388
919,66,36,30,18,48,712,557,20.0,25.52458696336844,24.93853874413993,45.03030303030303,54.96969696969697
920,66,38,28,20,46,712,557,21.0,24.79902875513596,26.079759123651918,45.03030303030303,54.96969696969697
921,67,41,26,20,47,712,557,21.686567164179106,25.27068415729754,26.221853156135293,45.134328358208954,54.865671641791046
922,68,41,27,19,49,712,558,21.75,24.739452802359306,26.966429550581868,44.9264705882353,55.0735294117647
923,70,41,29,21,49,712,558,22.12857142857143,26.46613906954275,24.991003787600107,43.98571428571429,56.01428571428571
924,71,46,25,23,48,712,558,22.816901408450704,27.69936149890297,22.554159627857594,43.929577464788736,56.070422535211264
925,74,48,26,25,49,712,558,22.89189189189189,28.523883701452938,22.719359541790297,43.83783783783784,56.16216216216216
926,75,48,27,24,51,713,559,22.28,28.91205572903681,22.27461093762986,44.16,55.84
927,77,49,28,28,49,714,561,21.0,27.205630297180647,24.839398214970892,44.5974025974026,55.4025974025974
928,81,53,28,28,53,714,561,20.962962962962962,29.448959704800224,22.32881807297755,44.71604938271605,55.28395061728395
929,83,53,30,28,55,714,562,21.012048192771083,30.243247877303446,21.69096242674627,45.33734939759036,54.66265060240964
930,83,52,31,27,56,715,563,20.91566265060241,31.80896457366513,19.383806510672223,46.45783132530121,53.54216867469879
931,84,51,33,26,58,716,564,20.61904761904762,34.97362444692668,17.881999180974955,46.17857142857143,53.82142857142857
932,83,48,35,24,59,716,567,20.518072289156628,35.26055601406809,17.80085451925725,45.78313253012048,54.21686746987952
933,81,46,35,23,58,717,570,19.864197530864196,36.34615981094195,16.04042548554974,46.53086419753087,53.46913580246913
934,77,42,35,21,56,718,574,19.441558441558442,34.85767522406312,17.94914331320149,47.36363636363637,52.63636363636363
935,75,39,36,19,56,719,577,18.64,33.633461125468884,18.82557467977283,47.626666666666665,52.373333333333335
936,72,36,36,17,55,719,580,18.88888888888889,31.663249495178206,19.922089422729353,48.05555555555556,51.94444444444444
937,70,35,35,17,53,719,582,19.514285714285716,30.208160913497053,21.560038156427357,47.02857142857143,52.97142857142857
938,70,34,36,18,52,719,583,20.071428571428573,30.33524967743339,21.650464608280895,46.785714285714285,53.214285714285715
939,70,38,32,18,52,719,583,21.071428571428573,31.53775819713832,19.876527517147395,46.785714285714285,53.214285714285715
940,65,38,27,17,48,720,587,22.123076923076923,28.422669392149977,21.60088232412974,47.86153846153846,52.13846153846154
941,65,40,25,19,46,720,588,22.923076923076923,27.709431264641236,23.46411241914205,48.01538461538462,51.98461538461538
942,63,43,20,21,42,720,590,23.96825396825397,26.052955798084678,23.202158004521817,46.714285714285715,53.285714285714285
943,61,45,16,20,41,721,592,24.18032786885246,21.463617892591035,28.039763576797018,45.24590163934426,54.75409836065574
944,63,47,16,20,43,721,592,24.41269841269841,21.309451428828652,29.023881904504684,44.333333333333336,55.666666666666664
945,65,47,18,20,45,721,592,24.661538461538463,22.82506174627774,27.221092099876106,44.89230769230769,55.10769230769231
946,67,47,20,22,45,721,592,24.925373134328357,23.186548396149313,26.186585932208896,45.134328358208954,54.865671641791046
947,71,49,22,24,47,722,592,23.746478873239436,26.25188135794128,25.719949627974216,46.225352112676056,53.774647887323944
948,72,50,22,24,48,722,593,23.88888888888889,25.50067142425342,24.221550797968803,46.90277777777778,53.09722222222222
949,76,52,24,24,52,722,593,23.63157894736842,28.29018904612437,23.288758322296683,46.60526315789474,53.39473684210526
950,75,53,22,23,52,723,593,24.24,29.669075299783586,18.837591366883082,47.13333333333333,52.86666666666667
951,77,53,24,23,54,723,594,24.116883116883116,32.02688668084874,18.258827604865548,47.37662337662338,52.62337662337662
952,75,52,23,23,52,723,596,24.946666666666665,32.36965287828049,16.070347121719507,47.13333333333333,52.86666666666667
953,76,51,25,24,52,723,597,25.210526315789473,33.92500900615121,17.364464678059317,47.35526315789474,52.64473684210526
954,75,50,25,30,45,723,599,25.56,33.01036315652637,18.365873770554966,47.46666666666667,52.53333333333333
955,73,46,27,28,45,724,602,24.602739726027398,32.74452382145702,18.16515997155635,48.02739726027397,51.97260273972603
956,71,43,28,27,44,724,605,24.464788732394368,30.309429559618476,21.578063259601347,48.63380281690141,51.36619718309859
957,68,41,27,25,43,725,607,24.720588235294116,28.68753447238041,22.339056385162962,49.205882352941174,50.794117647058826
958,71,40,31,24,47,725,608,24.08450704225352,29.98979935036985,24.503158396109026,49.690140845070424,50.309859154929576
959,68,36,32,23,45,727,610,23.191176470588236,28.858628447776947,23.48346716621577,49.14705882352941,50.85294117647059
960,68,36,32,21,47,728,611,22.61764705882353,29.86675131787719,24.122680588980067,49.8235294117647,50.1764705882353
961,70,39,31,21,49,728,611,22.97142857142857,31.43078905239645,22.526353804746403,49.34285714285714,50.65714285714286
962,70,39,31,20,50,729,612,22.7,31.820176816369433,22.379823183630567,49.27142857142857,50.72857142857143
963,67,39,28,21,46,729,616,22.791044776119403,27.45164725419026,26.632108328385552,50.507462686567166,49.492537313432834
964,68,40,28,22,46,730,617,21.941176470588236,28.929206925790776,26.97016842875799,50.294117647058826,49.705882352941174
965,70,42,28,21,49,731,617,21.428571428571427,31.62971946628336,24.47028053371664,50.51428571428571,49.48571428571429
966,70,39,31,19,51,732,620,20.12857142857143,29.137681023455404,29.16231897654459,48.8,51.2
967,70,39,31,20,50,733,621,19.771428571428572,29.55774361074888,27.385113532108267,49.82857142857143,50.17142857142857
968,69,39,30,23,46,733,622,20.44927536231884,29.730400289505244,26.443512753973014,49.44927536231884,50.55072463768116
969,71,41,30,23,48,733,622,20.87323943661972,32.20779341044265,23.904882645895377,50.25352112676056,49.74647887323944
970,68,38,30,23,45,734,625,20.235294117647058,31.87092850270602,22.49671855611751,50.01470588235294,49.98529411764706
971,67,38,29,21,46,735,626,20.059701492537314,32.86887718336265,21.534107891264217,50.52238805970149,49.47761194029851
972,64,35,29,18,46,736,629,19.21875,31.177156361309443,23.264917764021906,51.78125,48.21875
973,66,35,31,20,46,736,629,19.636363636363637,34.202640543918385,20.76705642577859,52.09090909090909,47.90909090909091
974,69,37,32,20,49,736,630,19.608695652173914,33.09348236868141,23.384778500883815,52.2463768115942,47.7536231884058
975,68,38,30,23,45,736,633,20.044117647058822,29.73117167737955,23.255028226532968,53.25,46.75
976,70,41,29,23,47,736,633,20.47142857142857,31.722555385551185,21.448873185877385,53.142857142857146,46.857142857142854
977,71,40,31,23,48,736,635,20.47887323943662,31.899875945418852,23.705757857398044,54.49295774647887,45.50704225352113
978,69,41,28,26,43,737,636,21.10144927536232,34.26369455670287,18.5189141389493,53.53623188405797,46.46376811594203
979,67,42,25,28,39,737,638,22.417910447761194,32.20682462161971,20.074553511763614,54.014925373134325,45.985074626865675
980,69,44,25,28,41,737,640,22.463768115942027,31.75679714941931,24.551830139895063,52.82608695652174,47.17391304347826
981,71,45,26,28,43,738,640,22.08450704225352,31.529458962134964,23.26966387115813,53.352112676056336,46.647887323943664
982,73,47,26,28,45,738,640,22.47945205479452,31.313444718560483,22.097514185549105,53.49315068493151,46.50684931506849
983,73,48,25,28,45,738,642,22.84931506849315,31.28507237864345,21.321384964794195,53.0,47.0
984,73,47,26,27,46,739,642,23.136986301369863,33.59043542464636,18.199669936242078,52.76712328767123,47.23287671232877
985,76,49,27,27,49,739,642,23.223684210526315,35.163705127232134,18.402084346452067,53.13157894736842,46.86842105263158
986,75,49,26,29,46,739,644,24.226666666666667,32.92749669385212,19.099098900714843,52.0,48.0
987,76,50,26,29,47,739,645,24.736842105263158,33.30833934406029,19.731134340150234,52.55263157894737,47.44736842105263
988,75,49,26,28,47,740,647,24.68,31.610149768187433,20.283489239827993,52.4,47.6
989,76,49,27,30,46,740,648,24.842105263157894,31.87072218951645,20.971383073641444,53.0,47.0
990,77,50,27,30,47,740,648,25.51948051948052,33.222402617265544,19.50487011000719,52.37662337662338,47.62337662337662
991,76,50,26,30,46,741,649,25.69736842105263,34.42968759243254,18.47820714440956,52.776315789473685,47.223684210526315
992,76,50,26,29,47,742,650,25.63157894736842,34.43121530452809,18.989837327050868,53.276315789473685,46.723684210526315
993,75,49,26,28,47,742,653,25.786666666666665,32.27393443128928,20.286065568710715,53.04,46.96
994,72,49,23,29,43,742,656,26.930555555555557,30.64688275248794,20.98926261867117,53.31944444444444,46.68055555555556
995,71,47,24,27,44,743,660,26.380281690140844,28.377665583077903,25.004524744946476,52.29577464788732,47.70422535211268
996,72,47,25,30,42,744,661,25.833333333333332,27.18813374941804,26.006310695026407,52.291666666666664,47.708333333333336
997,75,48,27,29,46,745,661,25.12,29.000365124357305,25.119634875642692,51.08,48.92
998,74,44,30,27,47,746,664,24.27027027027027,27.729862797568146,28.040409011246176,50.932432432432435,49.067567567567565
999,76,44,32,26,50,747,664,23.960526315789473,29.1854413343537,25.73567572348449,50.43421052631579,49.56578947368421
